District code,State name,District name,Population,Male,Female,Literate,Male_Literate,Female_Literate,Female_ST,Cultivator_Workers,Agricultural_Workers,Household_Workers,Other_Workers,Hindus,Muslims,Christians,Sikhs,Buddhists,Jains,Others_Religions,Below_Primary_Education,Primary_Education,Middle_Education,Secondary_Education,Higher_Education,Graduate_Education,Other_Education,Literate_Education,Illiterate_Education,Total_Education,Age_Group_0_29,Age_Group_30_49,Age_Group_50,Age not stated
1,JAMMU AND KASHMIR,Kupwara,870354,474190,396164,439654,282823,156831,33439,34680,56759,7946,129679,37128,823286,1700,5600,66,39,13,60616,101642,99947,74948,39709,21751,6402,405015,289765,694780,600759,178435,89679,1481
2,JAMMU AND KASHMIR,Badgam,753745,398041,355704,335649,207741,127908,11529,55299,36630,29102,93835,10110,736054,1489,5559,47,6,2,68336,80862,83141,66459,41367,27950,6857,374972,342646,717618,503223,160933,88978,611
3,JAMMU AND KASHMIR,Leh(Ladakh),133487,78971,54516,93770,62834,30936,48314,20869,1645,1020,51545,22882,19057,658,1092,88635,103,54,10452,15181,17900,16265,8923,6197,575,75493,32637,108130,70703,41515,21019,250
4,JAMMU AND KASHMIR,Kargil,140802,77785,63017,86236,56301,29935,59684,8266,3763,1222,38622,10341,108239,604,1171,20126,28,4,12732,19083,20874,16938,9826,3077,408,82938,39854,122792,87532,35561,17488,221
5,JAMMU AND KASHMIR,Punch,476835,251899,224936,261724,163333,98391,85827,54264,31583,3930,71616,32604,431279,958,11188,83,10,2,55762,72024,69219,46062,29517,13962,1884,288430,164044,452474,304979,109818,61334,704
6,JAMMU AND KASHMIR,Rajouri,642415,345351,297064,364109,224469,139640,111441,136527,24016,4656,125713,221880,402879,983,15513,189,26,3,70996,91859,108785,65921,35804,18576,3036,394977,242306,637283,404903,153165,83319,1028
7,JAMMU AND KASHMIR,Kathua,616435,326109,290326,389204,228499,160705,25614,69533,21566,3952,105380,540063,64234,1828,9551,24,16,2,69396,82715,106411,91522,47694,24330,4504,426572,181297,607869,357864,160123,97684,764
8,JAMMU AND KASHMIR,Baramula,1008039,534733,473306,545149,337170,207979,17468,57495,62246,15084,169375,30621,959185,1497,14770,140,29,7,76778,117000,137510,107837,57932,48285,9708,555050,350119,905169,636524,239659,130513,1343
9,JAMMU AND KASHMIR,Bandipore,392232,207680,184552,185979,117058,68921,35976,28232,32882,20484,67719,8439,382006,572,555,44,17,2,34064,47240,48849,35630,18644,12721,2268,199416,163648,363064,252378,90465,48802,587
10,JAMMU AND KASHMIR,Srinagar,1236829,651124,585705,748584,431746,316838,3914,12228,10408,20095,364457,42540,1177342,2746,12187,285,74,2,88911,173309,178723,176409,132727,121856,32114,904049,310225,1214274,693238,351561,190330,1700
11,JAMMU AND KASHMIR,Ganderbal,297446,158720,138726,143276,90581,52695,28516,15337,19312,7630,58611,5592,290581,406,486,25,8,4,25817,38735,38375,28247,15005,9633,2212,158024,116734,274758,194165,66945,35911,425
12,JAMMU AND KASHMIR,Pulwama,560440,293064,267376,293958,178326,115632,10770,49746,34080,10615,93979,13840,535159,1109,9440,35,6,18,36201,54808,73991,67368,40931,31286,5897,310482,190369,500851,342601,137032,80111,696
13,JAMMU AND KASHMIR,Shupiyan,266215,136480,129735,136500,80355,56145,10509,47424,10835,3395,26067,3116,262263,429,178,6,1,6,26468,29593,36939,28617,16501,10782,2010,150910,107053,257963,170086,60752,35158,219
14,JAMMU AND KASHMIR,Anantnag,1078692,559767,518925,545532,324417,221115,55016,140957,76364,16322,156041,13180,1057005,1449,6140,55,7,7,73719,99059,129174,97121,52407,41570,9160,502210,337265,839475,704145,239988,133519,1040
15,JAMMU AND KASHMIR,Kulgam,424483,217620,206863,209085,125052,84033,12637,69173,29928,6193,54696,4267,418076,460,1035,27,25,9,36066,47268,60470,45383,24214,18240,3190,234831,175199,410030,266858,99870,57253,502
16,JAMMU AND KASHMIR,Doda,409936,213641,196295,219083,138620,80463,18839,69947,12199,1932,67834,187621,220614,472,422,21,22,42,43794,47350,62719,48359,31416,12647,1846,248131,163565,411696,263576,93189,52744,427
17,JAMMU AND KASHMIR,Ramban,283713,149132,134581,124065,82938,41127,18832,41394,8810,2538,34470,81026,200516,414,753,43,3,252,33971,35284,35115,22591,13331,4923,1498,146713,141812,288525,188526,61604,33220,363
18,JAMMU AND KASHMIR,Kishtwar,230696,120165,110531,107506,68700,38806,18260,39271,16296,1186,26221,93931,133225,277,450,2094,3,514,25022,25675,27745,19550,14521,5438,2529,120480,101166,221646,145931,53415,31084,266
19,JAMMU AND KASHMIR,Udhampur,554985,296784,258201,322354,197543,124811,27167,113020,11396,2641,116615,489044,59771,1962,3418,106,57,235,58567,80129,86008,55024,29657,17345,4030,330760,194838,525598,339145,140785,74757,298
20,JAMMU AND KASHMIR,Reasi,314667,166461,148206,150542,93937,56605,42035,96147,4009,534,44077,153898,156275,1208,3107,15,7,3,33411,40215,36184,24066,14064,4733,575,153248,143293,296541,203967,70767,39743,190
21,JAMMU AND KASHMIR,Jammu,1529958,813821,716137,1137135,641916,495219,32870,68613,36873,10589,392547,1289240,107489,12104,114272,470,1987,321,135391,185962,253542,261852,159257,146501,30616,1173121,268279,1441400,816827,435895,275585,1651
22,JAMMU AND KASHMIR,Samba,318898,169124,149774,228139,130312,97827,8385,16894,6105,1520,68007,275311,22950,2306,17961,48,16,6,29138,41233,59931,61407,30503,14055,2600,238867,65643,304510,177277,88246,53022,353
23,HIMACHAL PRADESH,Chamba,519080,261320,257760,323842,186064,137778,67600,196665,9193,4521,83656,479782,32455,1559,2745,1740,57,14,56272,96789,67653,64515,40440,15506,3252,344427,154575,499002,306555,130606,81566,353
24,HIMACHAL PRADESH,Kangra,1510075,750591,759484,1152640,606443,546197,42819,303007,54849,15662,301652,1461140,19797,3023,8929,14511,194,208,127699,243617,223099,284124,192936,91236,13577,1176288,271892,1448180,766581,419172,319420,4902
25,HIMACHAL PRADESH,Lahul AND Spiti,31564,16588,14976,21845,12897,8948,12959,11227,572,167,7329,11649,74,212,35,19572,3,1,3776,5042,4011,3934,3557,2378,119,22817,6515,29332,15928,9181,6200,255
26,HIMACHAL PRADESH,Kullu,437903,225452,212451,307672,174550,133122,8329,197141,12372,2707,56864,415669,2974,1568,1396,15377,94,83,48384,77363,61854,58122,39081,23168,2377,310349,103136,413485,244727,120510,72282,384
27,HIMACHAL PRADESH,Mandi,999777,498065,501712,723747,393669,330078,6442,387944,15822,7134,161771,981412,9460,876,4081,2628,43,86,100052,159043,132147,180188,128549,54139,9350,763468,218570,982038,524285,279321,194661,1510
28,HIMACHAL PRADESH,Hamirpur,454768,217070,237698,358091,180555,177536,1513,147103,8824,3347,82657,449412,3711,243,591,95,293,9,37327,71107,72114,91184,64363,35620,5263,376978,72551,449529,224044,123941,106641,142
29,HIMACHAL PRADESH,Una,521173,263692,257481,399715,213281,186434,4156,84800,19604,3427,107515,480138,14275,390,26009,56,70,10,51838,87913,81256,105204,60626,32120,5511,424468,87735,512203,273223,142351,105358,241
30,HIMACHAL PRADESH,Bilaspur,381956,192764,189192,287620,155599,132021,5208,127169,4138,2561,72003,371973,6984,236,2387,113,10,7,35817,59489,53515,64730,45695,25474,3241,287961,65864,353825,193671,107367,80497,421
31,HIMACHAL PRADESH,Solan,580320,308754,271566,428578,244372,184206,12294,141267,10283,4969,142218,548579,14678,1452,13926,574,591,110,50331,89407,83992,95232,59363,36803,8280,423408,104084,527492,321533,167168,90808,811
32,HIMACHAL PRADESH,Sirmaur,529855,276289,253566,362645,205617,157028,5350,182958,10730,5313,81082,476830,33215,577,15501,2645,236,86,57853,100123,78103,67080,38282,23352,4048,368841,140486,509327,310244,136839,82471,301
33,HIMACHAL PRADESH,Shimla,814010,425039,388971,612642,342846,269796,4201,249786,26114,7967,147059,791449,11810,2025,4047,3262,185,197,69967,113536,113305,141490,95341,80414,9748,623801,137576,761377,425721,241956,145577,756
34,HIMACHAL PRADESH,Kinnaur,84121,46249,37872,60699,36697,24002,25137,32995,2537,944,19797,64732,448,485,249,18086,29,45,9400,13749,11437,11140,7871,5118,713,59428,16944,76372,42360,26599,15075,87
35,PUNJAB,Gurdaspur,2298323,1212617,1085706,1634719,907660,727059,0,147912,100684,30903,477639,1074332,27667,176587,1002874,405,580,812,180897,315156,290618,372317,243539,104345,22107,1528979,478020,2006999,1261421,611353,423301,2248
36,PUNJAB,Kapurthala,815168,426311,388857,576567,316254,260313,0,55252,42387,9861,176665,336124,10190,5445,453692,6662,553,334,71698,127031,112774,128828,77442,48221,9501,575495,174995,750490,433331,222324,157833,1680
37,PUNJAB,Jalandhar,2193590,1145211,1048379,1622537,882581,739956,0,85695,66664,29762,592351,1394329,30233,26016,718363,11385,4011,805,183441,333736,304652,339758,216646,162965,34576,1575774,387809,1963583,1159156,616431,416449,1554
38,PUNJAB,Hoshiarpur,1586625,809057,777568,1199699,637927,561772,0,89772,74362,15990,319698,1000743,23089,14968,538208,3476,2034,531,143871,256127,238975,301435,176013,93618,17427,1227466,294723,1522189,831741,422782,330671,1431
39,PUNJAB,Shahid Bhagat Singh Nagar,612310,313291,299019,438459,239155,199304,0,42608,22626,9011,130084,401368,6829,1479,192885,5885,695,266,53709,111242,94286,101970,61643,26893,5703,455446,133275,588721,318597,163305,128310,2098
40,PUNJAB,Fatehgarh Sahib,600163,320795,279368,426033,238696,187337,0,44245,21389,8048,141101,152851,16808,1698,427521,48,178,251,51897,102257,83931,95073,59555,34990,4607,432310,142314,574624,321018,166781,111028,1336
41,PUNJAB,Ludhiana,3498739,1867816,1630923,2560225,1428348,1131877,0,140737,98646,71667,973772,1502403,77713,16517,1863408,2007,19620,1254,277247,488129,443759,527568,318876,272280,44240,2372099,631980,3004079,1901528,980046,614258,2907
42,PUNJAB,Moga,995746,525920,469826,627889,348549,279340,0,91622,82397,18098,167055,158414,9388,3277,818921,178,436,365,98764,158812,116716,128693,85642,37417,11956,638000,306336,944336,535408,258826,194768,6744
43,PUNJAB,Firozpur,2029074,1071637,957437,1227511,707070,520441,0,191685,227971,14679,322360,906408,6844,19358,1090815,454,1143,278,196971,306838,226433,221806,147698,82448,25734,1207928,714869,1922797,1171770,525459,331259,586
44,PUNJAB,Muktsar,901896,475622,426274,524848,300401,224447,0,86565,111014,5187,132560,254920,4333,1681,638625,240,744,433,90240,137470,101852,104682,62612,36905,10666,544427,340886,885313,495167,242628,162297,1804
45,PUNJAB,Faridkot,617508,326671,290837,381285,215767,165518,0,53230,54058,8225,106042,141363,3125,1227,469789,155,1109,103,53734,89433,71178,75419,48360,29838,5790,373752,204895,578647,336540,164962,113721,2285
46,PUNJAB,Bathinda,1388525,743197,645328,844868,488261,356607,0,141535,128382,14938,265131,380569,16299,2474,984286,246,1266,559,117795,182796,145626,163928,96329,70240,16666,793380,438529,1231909,754927,377707,255283,608
47,PUNJAB,Mansa,769751,408732,361019,423560,244037,179523,0,105963,90367,13442,118740,156539,10375,917,598443,123,1577,493,75708,106162,84553,85953,48663,27461,5658,434158,311513,745671,420050,200882,146103,2716
48,PUNJAB,Patiala,1895686,1002522,893164,1266791,711052,555739,0,113182,89123,23647,434315,783306,40043,5683,1059944,245,1914,1410,173890,283837,239609,256826,157435,141947,27272,1280816,518772,1799588,1042519,517079,335100,988
49,PUNJAB,Amritsar,2490656,1318408,1172248,1684770,932981,751789,0,124617,121599,41642,629998,690939,12502,54344,1716935,876,3152,1044,197944,313874,283819,328229,203656,142399,15879,1485800,540010,2025810,1384987,667193,436496,1980
50,PUNJAB,Tarn Taran,1119627,589369,530258,666162,376427,289735,0,115853,81216,21328,162305,60504,3855,6095,1044903,101,650,47,106878,165659,118366,147856,83290,21322,5077,648448,381879,1030327,641875,283645,190898,3209
51,PUNJAB,Rupnagar,684627,357485,327142,502731,278534,224197,0,45640,21520,12321,154195,304481,14492,2094,361045,118,653,143,53005,107715,98135,116836,68794,38823,9388,492696,124100,616796,365300,185424,131707,2196
52,PUNJAB,Sahibzada Ajit Singh Nagar,994628,529253,465375,736575,409944,326631,0,40867,21791,13501,279836,476276,29488,5342,478908,257,1257,239,82178,131983,119930,147214,96568,105306,13103,696282,172226,868508,540872,281462,171656,638
53,PUNJAB,Sangrur,1655169,878029,777140,1002077,570413,431664,0,157191,91799,18578,301190,389410,179116,2406,1077438,268,3222,1038,163251,250833,197901,220210,130155,73636,18393,1054379,570103,1624482,904316,435148,311621,4084
54,PUNJAB,Barnala,595527,317522,278005,359831,201999,157832,0,60340,40460,5132,103399,112859,13100,622,467751,108,246,481,49367,90971,66695,81545,43467,23657,4665,360367,212388,572755,322607,158413,114077,430
55,CHANDIGARH,Chandigarh,1055450,580663,474787,805438,465346,340092,0,2578,1687,4799,395072,852574,51447,8720,138329,1160,1960,246,80406,118667,114209,124707,98786,174528,20188,731491,184265,915756,602411,303748,148945,346
56,UTTARAKHAND,Uttarkashi,330086,168597,161489,215126,128237,86889,1861,117264,4387,3122,32503,324859,3554,353,167,563,74,105,43442,46625,47640,30901,24989,18882,981,213460,83896,297356,202426,75997,51245,418
57,UTTARAKHAND,Chamoli,391605,193991,197614,280556,155395,125161,6239,121157,3845,5384,50554,385818,4395,428,323,190,11,23,47447,68435,67519,47703,32557,27168,2367,293196,61950,355146,229715,93182,67873,835
58,UTTARAKHAND,Rudraprayag,242285,114589,127696,170933,91803,79130,169,83155,3200,2112,24565,240170,1486,171,38,9,4,44,30562,50288,44605,28916,21131,15096,440,191038,45428,236466,141848,54979,44986,472
59,UTTARAKHAND,Tehri Garhwal,618931,297986,320945,407994,227406,180588,416,187121,8129,4021,81171,609835,7374,656,290,32,91,109,72163,103462,95417,74008,58434,30704,2073,436261,133013,569274,368324,139371,109998,1238
60,UTTARAKHAND,Dehradun,1696694,892199,804495,1259506,702216,557290,53399,77176,38195,22992,444405,1424916,202057,13416,36454,11778,5117,217,142130,236027,240639,206730,187700,247622,26644,1287492,296538,1584030,968517,446046,276280,5851
61,UTTARAKHAND,Garhwal,687271,326829,360442,494889,262148,232741,1041,150607,13715,5635,104195,660507,22931,2161,619,58,212,51,91101,107794,111671,95590,74219,52076,5638,538089,123071,661160,380765,160183,145445,878
62,UTTARAKHAND,Pithoragarh,483439,239306,244133,345550,189623,155927,9977,137332,5432,6055,67671,475105,6015,1401,260,185,13,30,63591,87585,90983,56591,42086,28375,2237,371448,88036,459484,273494,116749,92517,679
63,UTTARAKHAND,Bageshwar,259898,124326,135572,179483,97546,81937,1011,85125,8985,2991,26537,257509,1440,397,46,102,7,16,38113,47788,50340,31224,20785,10900,675,199825,49539,249364,147488,60569,51672,169
64,UTTARAKHAND,Almora,622506,291081,331425,436497,231604,204893,648,207617,10274,4312,76008,611250,7752,1895,256,201,31,6,90864,120029,115810,76148,53026,37742,2263,495882,109556,605438,351595,141238,128994,679
65,UTTARAKHAND,Champawat,259648,131125,128523,177726,102015,75711,562,59993,4032,1570,33971,249563,8693,870,336,24,28,6,36127,48093,45766,23610,18360,15110,1317,188383,62429,250812,156916,60722,41913,97
66,UTTARAKHAND,Nainital,954605,493666,460939,696500,385779,310721,3694,137530,34742,9767,194142,809717,120742,5091,17419,570,356,181,90915,155681,157875,115317,98851,89101,6200,713940,166573,880513,562548,243095,147053,1909
67,UTTARAKHAND,Udham Singh Nagar,1648902,858783,790119,1037839,598525,439314,61279,122686,165250,26396,277126,1104452,372267,6064,162768,505,738,159,179602,302653,232381,169274,113661,111062,11786,1120419,438598,1559017,1042614,392370,212223,1695
68,UTTARAKHAND,Hardwar,1890422,1005295,885127,1178354,691411,486943,2938,93660,103115,19955,361391,1214935,648119,4878,17364,709,2501,46,245515,336790,243719,165003,114114,134182,29377,1268700,580970,1849670,1207120,435385,246229,1688
69,HARYANA,Panchkula,561293,299679,261614,405318,229862,175456,0,26682,12827,9870,162100,490702,23451,2583,40951,1008,1626,90,45607,73584,60177,69163,48306,83256,8466,388559,119222,507781,309078,157076,93606,1533
70,HARYANA,Ambala,1128350,598703,529647,818025,461288,356737,0,52871,57293,15753,246222,955096,22143,3705,138202,381,4845,110,89558,170110,161844,163544,97980,91472,18727,793235,222031,1015266,617859,308126,201685,680
71,HARYANA,Yamunanagar,1214205,646718,567487,832457,474793,357664,0,61516,73251,12287,242179,984929,138569,3646,84455,161,1555,126,107222,194654,164652,159311,99170,82532,18666,826207,319428,1145635,694813,317708,201386,298
72,HARYANA,Kurukshetra,964655,510976,453679,646893,370828,276065,0,68908,85890,6726,175256,805175,15970,1943,140395,214,375,106,94530,145392,118107,120790,81964,71007,10999,642789,266638,909427,552034,250830,160216,1575
73,HARYANA,Kaithal,1074304,571003,503301,646529,385782,260747,0,128016,85651,9450,150782,974520,8232,1769,87558,265,351,70,119345,158239,124682,117753,82297,51043,9111,662470,369869,1032339,630194,265813,176320,1977
74,HARYANA,Karnal,1505324,797712,707612,978013,564516,413497,0,112288,133723,15311,254740,1341002,31650,2049,126207,532,1516,49,155839,231354,188040,183590,124790,101387,19186,1004186,429220,1433406,884972,380409,234684,5259
75,HARYANA,Panipat,1205437,646857,558580,786599,464136,322463,0,72120,62358,15824,262016,1083936,86622,2261,25064,289,4647,99,118873,170565,143466,141473,91756,75774,10977,752884,296212,1049096,739075,298764,167244,354
76,HARYANA,Sonipat,1450001,781299,668702,998316,589881,408435,0,142344,101733,18184,260918,1390149,45100,1405,4484,336,6033,29,138489,200458,182396,224639,150760,101186,19261,1017189,344813,1362002,855201,360216,233318,1266
77,HARYANA,Jind,1334152,713006,621146,832758,502049,330709,0,230387,102071,9114,181850,1276669,23016,889,29103,172,2594,56,136892,185626,151682,154773,107994,64599,14277,815843,419624,1235467,784085,335704,213478,885
78,HARYANA,Fatehabad,942011,495360,446651,557578,327471,230107,0,132250,97997,6558,132278,779243,8360,996,150969,171,1172,530,103541,136663,99948,93526,61476,37741,9504,542399,344534,886933,555745,237009,147469,1788
79,HARYANA,Sirsa,1295189,682582,612607,782897,456968,325929,0,164297,147042,11952,178712,940255,9524,2186,338962,370,2256,624,141766,201349,153263,134559,83373,61620,16698,792628,412353,1204981,750228,334344,208185,2432
80,HARYANA,Hisar,1743931,931562,812369,1114311,670200,444111,0,261120,144213,16097,270191,1701061,21650,1945,12270,334,3620,33,197303,230074,194595,202792,144626,105346,19031,1093767,505251,1599018,1017830,456536,265109,4456
81,HARYANA,Bhiwani,1634445,866672,767773,1069871,643158,426713,0,288543,103788,14855,215820,1611031,15515,873,2401,254,1016,26,186145,223049,198307,218631,148995,104875,13786,1093788,459364,1553152,964960,405760,261428,2297
82,HARYANA,Rohtak,1061204,568479,492725,747582,436025,311557,0,95732,36568,8521,205146,1043887,8185,732,3916,200,3491,24,117097,150903,140782,168499,109596,100346,21134,808357,248795,1057152,605741,269354,185685,424
83,HARYANA,Jhajjar,958405,514667,443738,676091,399480,276611,0,112389,44845,9254,160046,945693,8247,734,1042,105,645,22,90737,109829,115794,145258,97457,58826,9387,627288,201028,828316,549975,245095,162356,979
84,HARYANA,Mahendragarh,922088,486665,435423,630255,380440,249815,0,149146,38320,7639,143479,913251,5660,301,1737,75,644,15,94273,135849,126291,132765,94245,60296,10353,654072,245602,899674,530000,229392,161258,1438
85,HARYANA,Rewari,900332,474335,425997,636947,375453,261494,0,102698,28215,9782,197032,889133,5713,701,1804,202,1525,12,81280,120860,122617,139646,95807,65143,9820,635173,206827,842000,518747,230704,150557,324
86,HARYANA,Gurgaon,1514432,816690,697742,1111116,638666,472450,0,56046,27097,18228,443345,1408801,70842,9725,15097,944,7451,254,126920,177453,175370,219200,150120,233402,41366,1123831,263720,1387551,875531,428101,210307,493
87,HARYANA,Mewat,1089263,571162,518101,454897,308435,146462,0,104237,55278,6023,124426,221846,862647,1235,592,516,1453,4,125261,135842,67299,41836,22265,12453,5527,410483,619284,1029767,790930,186916,110688,729
88,HARYANA,Faridabad,1809733,966110,843623,1272739,734940,537799,0,27705,29288,32286,489950,1588407,161680,9743,34572,640,4883,249,137902,220384,198551,282666,178846,259933,27864,1306146,346567,1652713,1095602,481318,231029,1784
89,HARYANA,Palwal,1042708,554497,488211,599796,379696,220100,0,91506,60685,8566,148806,826342,208566,932,3971,345,915,20,125474,142156,113940,102626,65963,43780,8373,602312,393825,996137,684189,224043,133913,563
90,NCT OF DELHI,North West,3656539,1960922,1695617,2707855,1541952,1165903,0,11433,13289,35896,1127927,3211042,291330,14100,92129,2281,43460,345,228507,571255,607092,613393,519808,465677,22436,3028168,416720,3444888,2138591,1013424,503055,1469
91,NCT OF DELHI,North,887978,475002,412976,681517,381615,299902,0,2187,1791,11028,281440,726443,119792,7256,19066,1824,13049,81,58952,133915,142788,126121,97744,107099,11098,677717,125277,802994,506601,256501,124513,363
92,NCT OF DELHI,North East,2241624,1188425,1053199,1611588,912481,699107,0,2235,2406,30738,626007,1529337,657585,9123,17424,2388,24673,48,206524,500493,488767,341540,212438,122983,9199,1881944,257966,2139910,1393078,581016,264663,2867
93,NCT OF DELHI,East,1709346,907500,801846,1352998,748382,604616,0,1156,3094,19541,555901,1410852,178807,15792,53027,2643,46927,366,86484,219061,260094,267825,235187,246988,18644,1334283,169693,1503976,948963,497157,262124,1102
94,NCT OF DELHI,New Delhi,142004,77942,64062,114179,65678,48501,0,121,275,1030,58115,124482,8480,4852,2933,312,679,66,4641,11728,15326,15942,17742,23934,2186,91499,10098,101597,76076,43913,21773,242
95,NCT OF DELHI,Central,582320,307821,274499,442360,240518,201842,0,597,601,10902,195274,364148,194278,3527,13038,362,5886,107,34122,80924,96755,83244,62124,80251,6097,443517,87286,530803,317650,169533,94448,689
96,NCT OF DELHI,West,2543243,1356240,1187003,1961179,1093933,867246,0,2952,4358,29022,837988,2087294,149807,18337,271752,1993,11322,273,157606,318376,365913,369114,327114,440295,54376,2032794,308139,2340933,1399165,732515,408953,2610
97,NCT OF DELHI,South West,2292958,1246046,1046912,1787689,1025261,762428,0,9733,7753,18614,759252,2102743,112691,31226,31692,2784,9215,266,152945,255177,313817,335645,308513,400800,47723,1814620,278832,2093452,1296955,683209,308675,4119
98,NCT OF DELHI,South,2731929,1467428,1264501,2078402,1185036,893366,0,2984,5908,25081,890420,2155759,445914,41880,69520,3862,11020,645,191659,368772,400595,430091,354078,458858,52503,2256556,328287,2584843,1588001,785085,355602,3241
99,RAJASTHAN,Ganganagar,1969168,1043340,925828,1193343,710908,482435,6317,268297,230438,13790,400147,1437144,50688,2077,474853,938,1988,164,237042,314107,238397,163098,105734,104071,19396,1181845,710223,1892068,1167889,502211,283484,15584
100,RAJASTHAN,Hanumangarh,1774692,931184,843508,1034136,624281,409855,6711,370452,166833,13839,284136,1433067,118673,1542,216997,241,1935,138,239601,273441,219194,153628,104087,84185,14416,1088552,723454,1812006,1058044,453114,242361,21173
101,RAJASTHAN,Bikaner,2363937,1240801,1123136,1278801,782399,496402,3572,499223,103833,26244,356908,2073356,235741,1901,20072,285,30850,79,410155,333211,254335,143669,80296,101714,18577,1341957,1015331,2357288,1543867,517271,288165,14634
102,RAJASTHAN,Churu,2039547,1051446,988101,1149269,696729,452540,5342,572644,87983,16594,225608,1777879,249736,958,402,188,7104,127,336671,302022,237220,161520,100677,77282,13320,1228712,910226,2138938,1293193,458725,272176,15453
103,RAJASTHAN,Jhunjhunun,2137045,1095896,1041149,1370360,815834,554526,20249,521692,68878,13472,290607,1905682,228178,1004,275,56,548,85,296093,305626,301866,256621,192240,158936,25286,1536668,712584,2249252,1298780,494124,330126,14015
104,RAJASTHAN,Alwar,3674179,1939026,1735153,2182476,1359829,822647,135852,898891,216772,34562,558317,3039279,547335,2696,64532,4384,13221,348,492781,492981,468628,324050,230415,222622,31390,2262867,1384905,3647772,2346721,836000,490137,1321
105,RAJASTHAN,Bharatpur,2548462,1355726,1192736,1480869,943910,536959,25385,500994,238894,25068,306198,2143046,371286,1576,23456,899,5758,18,363676,330336,314953,211938,147520,132571,23311,1524305,1104824,2629129,1659515,546362,329127,13458
106,RAJASTHAN,Dhaulpur,1206516,653647,552869,683098,435721,247377,26792,229936,74342,12721,206213,1127520,72258,688,1356,92,2739,21,207566,172914,132964,77360,45590,37856,8194,682444,552106,1234550,815651,248416,141365,1084
107,RAJASTHAN,Karauli,1458248,783639,674609,805849,531904,273945,148760,335302,115367,9521,168536,1370977,81553,602,297,70,3424,413,220644,193938,170399,104208,69443,67639,14402,840673,668926,1509599,947173,310688,192042,8345
108,RAJASTHAN,Sawai Madhopur,1335551,704031,631520,741748,486184,255564,133103,313358,88804,12070,163836,1165505,155681,945,812,177,9991,42,205450,172925,151108,87349,57625,70870,14384,759711,586492,1346203,841697,309237,183234,1383
109,RAJASTHAN,Dausa,1634409,857787,776622,938051,596935,341116,204790,390960,76277,17185,200073,1582335,45488,439,296,94,3737,115,229035,235474,208537,135234,92559,90833,13764,1005436,681980,1687416,1047136,358718,210117,18438
110,RAJASTHAN,Jaipur,6626178,3468507,3157671,4300965,2554793,1746172,251328,744374,131523,91011,1497985,5819980,687452,12708,18782,1020,81079,257,819004,875940,823570,659389,455527,703673,96562,4433665,2046038,6479703,4091148,1646480,884057,4493
111,RAJASTHAN,Sikar,2677333,1374990,1302343,1652117,995275,656842,36251,501311,87889,22776,394528,2342076,327583,1122,356,177,4050,15,369959,438872,367412,282595,200430,181282,19321,1859871,967497,2827368,1672813,605002,381226,18292
112,RAJASTHAN,Nagaur,3307743,1696325,1611418,1758624,1102750,655874,4943,734614,263401,29647,398220,2833443,454487,1912,366,163,12940,276,513871,486057,388822,242053,147701,117444,14853,1910801,1533137,3443938,2088323,754143,463469,1808
113,RAJASTHAN,Jodhpur,3687165,1923928,1763237,2031532,1265753,765779,56955,592370,242017,42412,612942,3224399,411558,6035,4123,514,36697,80,497762,512035,405132,259304,154789,177199,30720,2036941,1591957,3628898,2359786,836322,489280,1777
114,RAJASTHAN,Jaisalmer,669919,361708,308211,308653,210415,98238,19932,132466,43872,6835,105730,497045,168129,874,1723,98,1521,34,109484,71132,41264,20142,12759,10604,1720,267105,397649,664754,448969,140294,79977,679
115,RAJASTHAN,Barmer,2603751,1369022,1234729,1188322,783461,404861,83647,754260,132696,30565,284961,2244882,321192,1157,450,157,34010,34,406804,352636,219932,101291,52272,39533,7328,1179796,1501858,2681654,1731122,527629,326476,18524
116,RAJASTHAN,Jalor,1828730,936634,892096,829582,543923,285659,85429,493355,158013,21867,223409,1732852,78990,730,231,144,14640,82,270997,277152,181691,75304,32366,25210,7850,870570,1033534,1904104,1176496,390598,249379,12257
117,RAJASTHAN,Sirohi,1036346,534231,502115,476806,309900,166906,143504,124080,97823,9443,188483,996562,30479,1284,572,114,6829,56,117971,147381,110385,58213,30724,27076,5251,497001,577092,1074093,649290,244401,142251,404
118,RAJASTHAN,Pali,2037573,1025422,1012151,1085693,667381,418312,70209,243491,237280,26119,335437,1870543,143476,1345,1540,141,18974,52,293818,359329,271312,144581,71472,67021,9403,1216936,983050,2199986,1207983,467436,343384,18770
119,RAJASTHAN,Ajmer,2583052,1324085,1258967,1526673,926268,600405,31074,298856,145523,35602,573741,2201663,314159,10605,6799,417,45614,184,379043,394576,313680,200191,130608,172683,28138,1618919,1034334,2653253,1561077,629951,388040,3984
120,RAJASTHAN,Tonk,1421326,728136,693190,749659,478329,271330,85530,326083,113426,16004,193648,1243527,153146,754,378,122,22458,30,237191,190750,154825,91853,64431,67155,9919,816124,661902,1478026,880194,334006,205593,1533
121,RAJASTHAN,Bundi,1110906,577160,533746,585044,371705,213339,109095,250453,111388,11172,153078,1017688,66609,682,11059,144,13455,24,153500,159218,121104,63248,41227,41052,6460,585809,553622,1139431,686771,267648,155958,529
122,RAJASTHAN,Bhilwara,2408523,1220736,1187787,1256126,777582,478544,112247,555168,163052,30149,399796,2224839,142427,1978,1468,183,35149,60,398993,338296,258990,141250,92785,106667,10928,1347909,1180456,2528365,1439454,589476,365023,14570
123,RAJASTHAN,Rajsamand,1156597,581339,575258,619139,383334,235805,79636,207582,106587,13505,223157,1105676,33677,759,260,100,14966,68,190090,190388,140839,72969,41063,34286,4732,674367,544517,1218884,687165,275099,193668,665
124,RAJASTHAN,Dungarpur,1388552,696532,692020,681591,415820,265771,491806,227849,184330,12514,216822,1340065,28662,830,240,226,16141,853,238847,175059,114245,60656,42887,39312,4834,675840,764563,1440403,868458,317700,191917,10477
125,RAJASTHAN,Banswara,1797485,907754,889731,829343,513854,315489,682523,546569,199370,19818,150817,1701234,48834,22250,427,138,22613,109,240067,190259,137780,75011,50438,47094,8145,748794,1040914,1789708,1153029,406214,216554,21688
126,RAJASTHAN,Chittaurgarh,1544338,783171,761167,821825,514851,306974,99653,453201,123469,15435,210650,1413163,97855,1274,1515,252,25843,136,245603,225700,170455,90889,58129,67155,10768,868699,715545,1584244,880043,398303,258997,6995
127,RAJASTHAN,Kota,1951014,1021161,929853,1298345,765396,532949,87388,140262,134992,25125,448432,1661307,243993,5665,11058,280,25742,286,286676,294591,250092,172538,118710,167778,27485,1317870,588142,1906012,1177474,495896,275396,2248
128,RAJASTHAN,Baran,1222755,633945,588810,693307,432607,260700,133763,216538,185037,15258,135750,1133349,79984,1432,3066,84,2795,48,203489,194024,144190,76209,46847,49939,8057,722755,545842,1268597,762204,286344,173100,1107
129,RAJASTHAN,Jhalawar,1411129,725143,685986,739792,466815,272977,88044,328714,209772,11199,136265,1299751,96164,842,819,46,12488,42,226614,203488,143108,73388,46267,47985,6972,747822,696680,1444502,850546,346110,213674,799
130,RAJASTHAN,Udaipur,3068420,1566801,1501619,1582629,973444,609185,752076,539106,302968,33535,490174,2869976,104307,7406,4278,209,78647,373,442946,386075,277392,164290,102085,142672,20010,1535470,1528671,3064141,1876436,739287,451034,1663
131,RAJASTHAN,Pratapgarh,867848,437744,430104,401515,250122,151393,273685,306419,96815,5516,72544,827293,25597,358,72,32,14077,27,142397,111276,70969,35206,21854,19109,2137,402948,488621,891569,545987,204801,115608,1452
132,UTTAR PRADESH,Saharanpur,3466382,1834106,1632276,2077108,1220114,856994,463,221567,273050,34032,508695,1966892,1454052,6523,18627,1937,10208,135,474060,600668,431491,256510,163463,154153,10083,2090428,1279517,3369945,2228689,769736,433862,34095
133,UTTAR PRADESH,Muzaffarnagar,4143512,2193434,1950078,2417339,1448528,968811,141,336049,323641,45952,586002,2382914,1711453,6495,18601,1516,16345,60,826387,780470,531913,281747,148770,98691,5608,2673586,1431537,4105123,2671757,911621,544283,15851
134,UTTAR PRADESH,Bijnor,3682713,1921215,1761498,2135393,1241471,893922,1470,232158,311489,52549,491840,2032081,1585210,6184,50624,1736,2134,41,498971,827447,549594,255028,159528,148185,14658,2453411,1308683,3762094,2404576,786305,450186,41646
135,UTTAR PRADESH,Moradabad,4772006,2503186,2268820,2263848,1357435,906413,308,368638,338384,88733,622056,2488265,2248392,13157,7555,1260,2426,382,635957,725118,492338,296210,186311,186489,23372,2545795,2097292,4643087,3168270,988486,525574,89676
136,UTTAR PRADESH,Rampur,2335819,1223889,1111930,1043666,630408,413258,151,214187,230238,54238,238598,1073890,1181337,9201,65316,384,1307,63,278477,374898,171242,85117,51703,43839,3169,1008445,1235413,2243858,1576123,491164,258913,9619
137,UTTAR PRADESH,Jyotiba Phule Nagar,1840221,963449,876772,983110,600541,382569,75,217672,131877,31600,217940,1075440,750368,5952,5295,189,517,21,251669,352835,230640,161282,164763,69522,3021,1233732,520215,1753947,1227283,391275,215849,5814
138,UTTAR PRADESH,Meerut,3443689,1825743,1617946,2141488,1254520,886968,1562,196068,153995,63096,677380,2183255,1185643,10582,24912,1855,18544,236,412280,495861,469403,359944,254337,275076,36096,2302997,990312,3293309,2165117,780475,451827,46270
139,UTTAR PRADESH,Baghpat,1303048,700070,602978,797970,489858,308112,4,124718,74500,20347,197130,917474,364583,1840,483,161,16139,25,139646,272939,215070,132197,79475,44164,3730,887221,376700,1263921,817140,283276,194548,8084
140,UTTAR PRADESH,Ghaziabad,4681645,2488834,2192811,3123264,1811397,1311867,1864,158868,123680,83672,1154318,3414427,1186776,19026,23001,3487,16412,265,534606,858286,797473,597661,475439,255949,26399,3545813,885070,4430883,2891069,1139871,559963,90742
141,UTTAR PRADESH,Gautam Buddha Nagar,1648115,890214,757901,1122947,666065,456882,1026,72668,48845,35400,412196,1394025,215500,7366,9261,895,4518,91,201277,330623,283031,218587,194796,101645,5058,1335017,342284,1677301,1015648,402967,188862,40638
142,UTTAR PRADESH,Bulandshahr,3499171,1845260,1653911,2031656,1253314,778342,80,332475,241137,65937,533711,2707195,777407,4088,2765,669,1572,86,443641,540754,475146,338138,217882,151182,17796,2184539,1185318,3369857,2246254,753949,472808,26160
143,UTTAR PRADESH,Aligarh,3673889,1951996,1721893,2092567,1283380,809187,289,281501,267197,78566,547097,2904140,729283,7635,5875,2582,2805,91,456870,491605,443958,334738,216997,172585,20498,2137251,1352181,3489432,2378289,787408,472667,35525
144,UTTAR PRADESH,Mahamaya Nagar,1564708,836127,728581,942572,579157,363415,131,124231,154720,32402,172762,1397225,159448,1350,524,424,1289,63,181444,297282,269717,166861,89435,49812,5386,1059937,430814,1490751,1011157,339137,210083,4331
145,UTTAR PRADESH,Mathura,2547184,1367125,1180059,1507746,943346,564400,694,235886,179248,44453,381352,2310776,216933,3179,2872,883,2056,126,303291,420976,344961,233264,155937,103102,10262,1571793,691359,2263152,1600686,535738,327854,82906
146,UTTAR PRADESH,Agra,4418797,2364953,2053844,2680510,1614594,1065916,3428,285471,234455,94184,775734,3922718,411313,10076,12057,4049,21508,384,600839,904836,647340,450571,317618,199395,20781,3141380,963202,4104582,2871903,991255,547873,7766
147,UTTAR PRADESH,Firozabad,2498156,1332046,1166110,1521806,912314,609492,1219,184595,150221,59942,366763,2140745,314812,3370,1804,3395,19077,61,324525,416295,368905,277163,166249,108627,11313,1673077,672115,2345192,1621154,543730,312689,20583
148,UTTAR PRADESH,Mainpuri,1868529,993377,875152,1203885,712110,491775,220,270888,137174,24784,127994,1746649,100723,1729,475,8814,4161,38,234774,353287,319158,230731,144516,111696,12281,1406443,519493,1925936,1193660,402321,265638,6910
149,UTTAR PRADESH,Budaun,3681896,1967759,1714137,1547477,986501,560976,28,575903,258758,40122,232560,2867707,790515,6320,1135,1959,678,87,556130,585283,295943,154425,86760,64222,7291,1750054,1946345,3696399,2436051,748408,424194,73243
150,UTTAR PRADESH,Bareilly,4448359,2357665,2090694,2191759,1342697,849062,1563,365985,326376,131699,577911,2830768,1536534,14822,28187,4371,931,339,717585,641251,442110,272840,172554,146446,16806,2409592,1744527,4154119,2893965,952233,514141,88020
151,UTTAR PRADESH,Pilibhit,2031007,1072002,959005,1061095,654290,406805,822,216476,224192,22782,155155,1449007,489686,3510,84787,360,138,45,294135,281158,240057,117838,77602,66129,9713,1086632,977839,2064471,1320476,449673,256276,4582
152,UTTAR PRADESH,Shahjahanpur,3006538,1606403,1400135,1490930,915142,575788,249,344973,275192,31141,240908,2412595,527581,4630,51090,2312,301,84,451571,476064,315873,158430,96308,87355,8885,1594486,1324615,2919101,1961237,652237,368743,24321
153,UTTAR PRADESH,Kheri,4021243,2123187,1898056,2034044,1237157,796887,26391,529223,422142,47837,265516,3078262,807600,7502,94388,18454,487,226,717340,621684,442748,223669,129627,128548,10846,2274462,1833578,4108040,2582597,896611,510832,31203
154,UTTAR PRADESH,Sitapur,4483992,2375264,2108728,2283733,1397702,886031,769,571097,473554,70971,306980,3555450,893725,6579,11611,2663,1410,79,714304,656401,482220,221898,136383,127750,8775,2347731,2141696,4489427,2862383,1000987,588318,32304
155,UTTAR PRADESH,Hardoi,4092845,2191442,1901403,2221601,1374587,847014,163,596813,406830,59649,255654,3508131,556219,5822,5688,6671,446,98,741817,906861,510507,247265,138583,103523,9048,2657604,1481604,4139208,2598364,905306,559988,29187
156,UTTAR PRADESH,Unnao,3108367,1630087,1478280,1773584,1053063,720521,1368,450123,332663,49243,292715,2732016,363453,3574,1204,920,240,31,501457,512965,415378,240024,136688,101934,7173,1915619,1130103,3045722,1893706,706851,453462,54348
157,UTTAR PRADESH,Lucknow,4589838,2394476,2195362,3127260,1742440,1384820,3470,175578,203029,99863,1064336,3537787,985070,20493,23883,3877,4975,504,489898,554301,552171,428121,378742,639260,52132,3094625,1146880,4241505,2678289,1161686,685258,64605
158,UTTAR PRADESH,Rae Bareli,3405559,1752542,1653017,1965843,1165965,799878,880,316891,507882,60774,319163,2975998,413243,3634,2424,722,397,602,540661,538301,477689,270775,182823,153041,15662,2178952,1286726,3465678,2116007,776583,506583,6386
159,UTTAR PRADESH,Farrukhabad,1885204,1006240,878964,1092677,654827,437850,106,245089,135679,43528,167971,1596278,276846,3137,3160,3161,487,100,270550,330084,257279,184298,115069,110391,9368,1277039,710960,1987999,1224584,411153,246795,2672
160,UTTAR PRADESH,Kannauj,1656616,881776,774840,1017087,603596,413491,6,239350,129517,51330,104479,1375788,273967,1263,504,2033,606,65,237853,283674,263749,175582,107628,95072,7194,1170752,543034,1713786,1069916,361028,223535,2137
161,UTTAR PRADESH,Etawah,1581810,845856,735954,1062003,623583,438420,80,170827,158026,20803,156416,1457892,113961,1362,1045,1733,3917,94,171216,292852,298700,195192,121283,118571,13400,1211214,397708,1608922,979633,362026,237786,2365
162,UTTAR PRADESH,Auraiya,1379545,740040,639505,930836,546198,384638,59,166731,151727,12533,111032,1273546,101963,1004,371,332,228,444,133123,291837,282449,168866,101542,79012,6531,1063360,276224,1339584,856336,320763,202054,392
163,UTTAR PRADESH,Kanpur Dehat,1796184,963255,832929,1170243,692964,477279,403,224986,234069,20783,149026,1612968,176327,1300,478,819,155,103,235341,344866,341845,223529,157167,97740,5930,1406418,475166,1881584,1100820,415918,276272,3174
164,UTTAR PRADESH,Kanpur Nagar,4581268,2459806,2121462,3243022,1829179,1413843,1645,198547,258790,68738,1046157,3792174,720660,15751,29676,2733,5710,589,338620,766906,794860,651228,515772,396565,26827,3490778,676306,4167084,2630411,1209554,731795,9508
165,UTTAR PRADESH,Jalaun,1689974,906092,783882,1075196,653430,421766,404,196613,243035,26109,155007,1509708,171581,1148,463,2875,256,145,169207,327534,282919,167911,104699,106888,10399,1169557,461666,1631223,1002817,410090,274954,2113
166,UTTAR PRADESH,Jhansi,1998603,1057436,941167,1304513,783705,520808,1799,228881,248072,48648,289313,1823930,147842,7050,4951,1203,7328,311,184997,370685,341371,186348,99814,92586,11783,1287584,483088,1770672,1171301,510728,308331,8243
167,UTTAR PRADESH,Lalitpur,1221592,641011,580581,641191,397586,243605,34776,267580,131354,14882,89535,1163804,33724,1351,1034,69,20390,41,185575,202692,154118,61543,32237,34658,3535,674358,509536,1183894,793551,265080,159666,3295
168,UTTAR PRADESH,Hamirpur,1104285,593537,510748,653299,408125,245174,215,130314,181449,19876,112016,1010014,91269,814,196,74,41,273,159593,238344,211029,103334,59914,59612,4094,835920,364848,1200768,660774,260368,181109,2034
169,UTTAR PRADESH,Mahoba,875958,466358,409600,488106,302283,185823,292,114244,130422,13523,91487,815142,57454,965,389,94,234,157,119002,141201,131165,60400,33810,37165,3926,526669,403649,930318,527067,201394,137393,10104
170,UTTAR PRADESH,Banda,1799410,965876,833534,1002937,630626,372311,81,251755,273458,19098,157378,1637549,157612,1367,231,168,916,50,325773,415195,249238,114783,61702,63112,5728,1235531,588025,1823556,1120432,408527,265310,5141
171,UTTAR PRADESH,Chitrakoot,991730,527721,464009,531072,330339,200733,170,160094,150695,12555,70853,955372,34559,693,63,101,285,27,168472,174106,124256,69641,40266,35826,3660,616227,383908,1000135,638046,214228,136669,2787
172,UTTAR PRADESH,Fatehpur,2632733,1384722,1248011,1512166,911003,601163,151,328758,425366,51555,258250,2274674,350700,2201,402,172,199,47,409875,463642,376472,227119,134445,116445,10212,1738210,895178,2633388,1624830,603831,395547,8525
173,UTTAR PRADESH,Pratapgarh,3209141,1606085,1603056,1931559,1121381,810178,343,305746,386563,68642,305650,2731351,452394,3920,1451,7795,746,43,427626,558350,456752,332742,238011,197846,20047,2231374,1059636,3291010,2002569,703727,492097,10748
174,UTTAR PRADESH,Kaushambi,1599596,838485,761111,813424,507279,306145,91,141102,321410,30491,146083,1372381,220423,2225,522,687,545,3,184229,253910,180825,146757,89011,45341,5115,905188,670750,1575938,1034099,336401,210556,18540
175,UTTAR PRADESH,Allahabad,5954391,3131807,2822584,3665727,2199340,1466387,3685,474283,541146,185877,910601,5102041,796756,13782,4377,4391,2247,305,823863,934881,738076,596615,502826,428871,36764,4061896,1756098,5817994,3764404,1335224,818137,36626
176,UTTAR PRADESH,Bara Banki,3260699,1707073,1553626,1692458,1010518,681940,277,458479,421973,77235,235163,2505444,737106,4857,2090,1553,3016,211,533140,420824,350564,197780,132332,113799,12281,1760720,1540841,3301561,2043335,709494,445269,62601
177,UTTAR PRADESH,Faizabad,2470996,1259628,1211368,1450901,838339,612562,462,260406,272734,43505,254564,2094271,365806,3225,1912,737,358,185,356093,361114,347114,231129,176303,179996,18947,1670696,981915,2652611,1534832,543148,367332,25684
178,UTTAR PRADESH,Ambedkar Nagar,2397888,1212410,1185478,1486939,846676,640263,340,213814,301120,58520,213944,1985654,401678,2536,869,1817,235,33,342667,392873,353570,247028,172872,194387,15458,1718855,813502,2532357,1499494,515229,367234,15931
179,UTTAR PRADESH,Sultanpur,3797117,1914586,1882531,2239902,1300248,939654,338,338890,501634,85785,316323,3119590,650261,4453,1629,9989,426,336,460210,637015,526973,306046,188848,176414,15277,2310783,1118891,3429674,2376875,828222,580164,11856
180,UTTAR PRADESH,Bahraich,3487731,1843884,1643847,1398368,878285,520083,5553,430227,482897,37965,201071,2291892,1169330,6400,8212,2793,1177,38,447648,493760,215939,104762,65106,47690,7028,1381933,1920966,3302899,2275746,754346,446242,11397
181,UTTAR PRADESH,Shrawasti,1117361,593897,523464,423313,276700,146613,2645,163449,165118,18494,56694,768643,343981,1427,407,323,68,56,155698,97160,56242,29567,19744,15648,1535,375594,701550,1077144,723443,245098,143979,4841
182,UTTAR PRADESH,Balrampur,2148665,1114721,1033944,868357,544943,323414,12230,276614,328768,29916,124955,1333242,805975,3228,900,1866,198,87,379253,227932,122911,65516,40633,37109,2777,876131,1332817,2208948,1415213,442339,283947,7166
183,UTTAR PRADESH,Gonda,3433919,1787146,1646773,1679994,1034181,645813,394,440340,431532,65299,233381,2739076,678615,4735,1893,649,338,57,678171,425584,305644,192664,144067,118176,8722,1873028,1620782,3493810,2223078,734903,464584,11354
184,UTTAR PRADESH,Siddharthnagar,2559297,1295095,1264202,1228926,740718,488208,5934,298360,395993,35756,148789,1789704,748073,3042,681,11964,179,356,676987,335977,204260,110056,73465,56516,10526,1467787,1217027,2684814,1690396,504002,359977,4922
185,UTTAR PRADESH,Basti,2464464,1255272,1209192,1393783,819719,574064,1744,296928,282260,36856,167644,2082976,364510,3493,900,9753,107,99,470355,349221,324085,211477,162961,143642,13030,1674771,1021192,2695963,1574037,519265,363891,7271
186,UTTAR PRADESH,Sant Kabir Nagar,1715183,869656,845527,954949,567098,387851,770,149604,241825,28884,119156,1300586,404410,1766,447,4393,95,35,341757,290532,205875,129442,86528,63506,8882,1126522,683053,1809575,1108368,352395,250502,3918
187,UTTAR PRADESH,Mahrajganj,2684703,1381754,1302949,1419144,881674,537470,8074,229847,532486,43015,188905,2196884,458650,3527,1381,16030,243,338,456350,388464,308064,185236,129222,95863,11219,1574418,1252595,2827013,1694493,595114,370573,24523
188,UTTAR PRADESH,Gorakhpur,4440895,2277777,2163118,2700328,1593890,1106438,8911,255660,454931,82965,558073,4009037,403847,9662,2123,2848,460,207,873031,618398,560246,425913,316166,273903,36253,3103910,1453960,4557870,2755630,992114,659677,33474
189,UTTAR PRADESH,Kushinagar,3564544,1818055,1746489,1954820,1183722,771098,39266,265686,528388,57049,265850,2928462,620244,5006,767,4619,383,133,836856,424892,367405,249265,170911,119625,11970,2180924,1550315,3731239,2236842,772777,500373,54552
190,UTTAR PRADESH,Deoria,3100946,1537436,1563510,1875239,1079288,795951,55678,238237,291016,50418,296575,2730957,358539,3626,818,1182,209,146,602403,473097,449571,372031,277548,194341,23334,2392325,1130108,3522433,1946336,664708,481219,8683
191,UTTAR PRADESH,Azamgarh,4613913,2285004,2328909,2771917,1559414,1212503,4637,425630,452055,115991,378356,3878626,718692,3810,719,5652,183,226,831966,1344726,879745,489060,312571,158303,8087,4024458,1218146,5242604,2930243,965876,699954,17840
192,UTTAR PRADESH,Mau,2205968,1114709,1091259,1363044,773082,589962,11451,145225,212343,118614,220565,1769937,428555,2109,340,564,155,129,344570,410737,320743,256784,209493,150462,15771,1708560,659237,2367797,1402738,467343,323260,12627
193,UTTAR PRADESH,Ballia,3239774,1672902,1566872,1963590,1160960,802630,53297,206228,384432,72194,356629,3004240,213440,4463,892,1595,233,64,436021,515010,443440,409484,323582,200434,20283,2348254,1032533,3380787,1975934,724362,502628,36850
194,UTTAR PRADESH,Jaunpur,4494204,2220465,2273739,2731677,1565394,1166283,2373,540762,436792,88404,371417,3981502,483750,4947,1286,7898,349,114,665376,939616,769693,520111,353996,256398,25909,3531099,1344789,4875888,2826453,927026,689979,50746
195,UTTAR PRADESH,Ghazipur,3620268,1855075,1765193,2197549,1293553,903996,14048,368943,435934,68254,331471,3233790,368153,4181,810,3145,213,184,566504,691057,563310,449909,334003,186306,12795,2803884,1008996,3812880,2234593,774130,556273,55272
196,UTTAR PRADESH,Chandauli,1952756,1017905,934851,1174606,699454,475152,20154,125980,248674,58552,219337,1727869,215081,2153,1389,340,100,1175,295979,367768,276638,196240,135962,88299,7586,1368472,543247,1911719,1222695,437000,287767,5294
197,UTTAR PRADESH,Varanasi,3676841,1921857,1754984,2403903,1389116,1014787,13625,197952,182146,168764,671846,3107681,546987,7696,3309,1146,1898,298,467782,608174,557052,447926,351391,281652,34841,2748818,906367,3655185,2260457,856070,531549,28765
198,UTTAR PRADESH,Sant Ravidas Nagar (Bhadohi),1578213,807099,771114,910146,546782,363364,887,94402,104419,62665,209122,1368291,203887,1365,199,1562,161,7,257527,291926,232072,167524,120944,86533,10304,1166830,552958,1719788,1032294,331743,209920,4256
199,UTTAR PRADESH,Mirzapur,2496970,1312302,1184668,1428683,865837,562846,9652,178132,334372,80246,289246,2292534,195765,2373,1133,341,701,27,361642,421577,340261,232189,177109,140668,17680,1691126,868542,2559668,1590528,552177,346773,7492
200,UTTAR PRADESH,Sonbhadra,1862559,971344,891215,985708,601988,383720,187193,141007,371261,29417,188714,1738769,103567,3963,1649,1747,487,1907,306218,297226,212565,120822,82614,63846,9357,1092648,745126,1837774,1203938,418914,237866,1841
201,UTTAR PRADESH,Etah,1774480,947339,827141,1055202,647042,408160,53,242396,131779,28396,143413,1611126,146346,2464,708,2887,5671,18,238019,214091,201984,178434,119665,88607,8092,1048892,718310,1767202,1149372,383707,237427,3974
202,UTTAR PRADESH,Kanshiram Nagar,1436719,764165,672554,724850,452803,272047,70,229088,107094,22492,114091,1211427,213822,1969,2280,3907,313,72,256688,193410,150247,108558,61662,48079,4981,823625,648166,1471791,946320,301252,183434,5713
203,BIHAR,Pashchim Champaran,3935042,2061110,1873932,1759481,1091226,668255,122366,217539,998833,38691,223884,3047427,865090,8469,926,1337,296,1895,1053481,543965,250243,159563,98732,70669,6035,2182688,1710878,3893566,2544205,888205,497793,4839
204,BIHAR,Purba Champaran,5099371,2681209,2418162,2276957,1407603,869354,6007,349032,1057417,46164,284926,4086453,990349,4865,668,878,464,104,1280809,982506,450631,241118,121594,68781,5149,3150588,2142757,5293345,3316422,1122340,648009,12600
205,BIHAR,Sheohar,656246,346673,309573,283698,171645,112053,141,38727,136334,9119,32192,552492,99342,522,216,73,52,44,128209,91277,37063,25657,16031,10091,661,308989,348078,657067,421241,139909,93398,1698
206,BIHAR,Sitamarhi,3423574,1803252,1620322,1436794,885188,551606,1404,216012,635907,37932,224732,2672311,740101,2897,261,253,188,20,733380,394422,196321,136500,92783,70549,11936,1635891,1852765,3488656,2206340,739982,449035,28217
207,BIHAR,Madhubani,4487379,2329313,2158066,2155338,1340085,815253,1934,396880,940642,54934,244482,3652168,818912,3262,564,328,442,169,783888,771417,520875,303114,170563,137780,11352,2698989,2003079,4702068,2860455,1009424,611899,5601
208,BIHAR,Supaul,2229076,1155283,1073793,1033283,647672,385611,4926,201882,554271,22555,98974,1809936,409251,3758,271,136,546,42,467768,269737,157787,99530,69665,45726,5850,1116063,1220268,2336331,1453438,495020,277610,3008
209,BIHAR,Araria,2811569,1463333,1348236,1195768,727643,468125,18961,222913,691947,24367,130666,1593525,1207442,4116,371,187,1910,63,625357,426625,206161,112955,68177,39627,6938,1485840,1653766,3139606,1872943,612012,324091,2523
210,BIHAR,Kishanganj,1690400,866970,823430,745056,439921,305135,31718,107862,321867,11633,87702,531236,1149095,5783,398,183,1476,28,356401,235779,89025,42778,25989,15386,3761,769119,945397,1714516,1139615,361114,188447,1224
211,BIHAR,Purnia,3264619,1699370,1565249,1332326,805261,527065,68099,197424,745015,28840,172039,1989420,1255641,7989,614,353,1450,650,668690,360243,184327,119259,83226,59996,11116,1486857,1798786,3285643,2155512,696556,372692,39859
212,BIHAR,Katihar,3071029,1600430,1470599,1280190,762256,517934,87781,168857,672291,20577,151841,1684589,1365645,8659,2754,212,507,2141,472616,444260,237243,133811,88498,57114,11896,1445438,1705551,3150989,2054202,660403,353483,2941
213,BIHAR,Madhepura,2001762,1047559,954203,834577,517666,316911,6090,190809,484062,16347,86328,1753829,241760,1342,170,60,133,81,340813,189431,114474,99437,79891,44955,6509,875510,1202278,2077788,1311771,444235,242382,3374
214,BIHAR,Saharsa,1900661,997174,903487,804996,506374,298622,2908,164600,356833,18651,109814,1629254,266620,1292,197,60,109,8,348300,194897,104182,90182,64560,47051,6016,855188,1151349,2006537,1249692,415863,233870,1236
215,BIHAR,Darbhanga,3937385,2059949,1877436,1816634,1125566,691068,1411,236673,642115,44846,300006,3042729,881476,3534,832,245,236,101,672797,490534,332382,224622,152540,129597,26073,2028545,2203198,4231743,2535344,865971,529314,6756
216,BIHAR,Muzaffarpur,4801062,2527497,2273565,2509232,1487117,1022115,2855,273436,769001,65253,439896,4032773,745546,5149,933,288,382,98,1092952,743623,419433,299475,194920,138916,14475,2903794,1924438,4828232,3016735,1079189,697108,8030
217,BIHAR,Gopalganj,2562012,1267666,1294346,1382998,793905,589093,30974,208959,338666,26049,154527,2119262,436057,2463,271,167,133,28,540603,470828,291624,223776,123249,79109,7690,1736879,977719,2714598,1642807,546202,370662,2341
218,BIHAR,Siwan,3330464,1675090,1655374,1930175,1115906,814269,43528,264928,376344,31244,259900,2712635,608282,2618,369,407,359,86,689880,612635,445257,355277,186817,119164,12091,2421121,1207119,3628240,2115448,713597,498299,3120
219,BIHAR,Saran,3951862,2022821,1929041,2157454,1285767,871687,18464,232097,493461,42103,272570,3534772,406449,2330,371,229,322,107,793945,693465,433759,361171,213251,148065,9848,2653504,1313700,3967204,2516115,847031,585386,3330
220,BIHAR,Vaishali,3495021,1844535,1650486,1926740,1152576,774164,1042,255017,502637,36958,265732,3152346,333980,2203,707,362,246,71,810191,487594,370247,291392,178320,124448,9094,2271286,1479152,3750438,2176701,759132,486032,73156
221,BIHAR,Samastipur,4261566,2230003,2031563,2142880,1293575,849305,909,299039,721629,47917,274815,3800598,452370,2126,554,292,231,112,781038,710468,438908,284082,186153,129933,19126,2549708,1996651,4546359,2766930,913339,568812,12485
222,BIHAR,Begusarai,2970541,1567660,1402881,1548673,918507,630166,749,146035,430870,58167,303110,2554330,407348,2209,402,229,276,57,577601,484502,291877,207136,144783,101836,14599,1822334,1242551,3064885,1951688,644874,369996,3983
223,BIHAR,Khagaria,1666886,883786,783100,768028,461153,306875,323,104517,325731,20816,109741,1486989,175588,1253,143,79,86,115,350601,233494,130004,100555,65931,38697,5969,925251,903323,1828574,1114645,355531,195796,914
224,BIHAR,Bhagalpur,3037766,1615663,1422103,1573066,937669,635397,31635,135161,475228,60461,312678,2487866,537098,3556,415,180,1050,32,614644,524322,300767,247079,154643,118843,16119,1976417,1139715,3116132,1952879,674660,397654,12573
225,BIHAR,Banka,2034763,1067140,967623,965321,590961,374360,44531,172440,462614,26680,109346,1772655,250925,6138,139,113,94,1035,408188,386707,196305,120653,63103,35767,3922,1214645,879831,2094476,1291235,462080,278863,2585
226,BIHAR,Munger,1367765,729041,638724,801817,473741,328076,10409,45953,196449,16690,167566,1252319,110416,1815,338,95,145,61,226699,158699,146414,147152,101907,64469,4394,849734,498676,1348410,860147,316713,188319,2586
227,BIHAR,Lakhisarai,1000912,526345,474567,507270,305182,202088,4086,78532,159970,13546,74528,956396,40886,487,140,52,78,52,172076,149312,111684,85807,48001,27261,3814,597955,450967,1048922,650642,218840,130655,775
228,BIHAR,Sheikhpura,636342,329743,306599,328676,196431,132245,312,54511,109696,9917,50531,596102,37653,313,75,41,43,31,129673,110525,59529,52860,33856,19676,3399,409518,305609,715127,413475,136898,85045,924
229,BIHAR,Nalanda,2877653,1497060,1380593,1519933,919558,600375,714,221240,534021,52585,237574,2669775,198033,1978,393,414,561,64,581978,486266,320839,274556,177358,133032,11159,1985188,1324385,3309573,1829128,642197,403129,3199
230,BIHAR,Patna,5838465,3078512,2759953,3459679,2028047,1431632,4352,271216,658203,85349,867118,5356075,439952,12551,4803,1062,2151,203,1244842,1095655,920051,698351,463361,452340,46126,4920726,2590473,7511199,3626564,1382654,815638,13609
231,BIHAR,Bhojpur,2728407,1430380,1298027,1599151,973486,625665,6614,190896,364875,47985,218737,2518216,197819,2165,544,647,1472,48,581580,605307,367059,313509,163303,131137,10630,2172525,1005140,3177665,1722387,613072,387389,5559
232,BIHAR,Buxar,1706352,887977,818375,989807,593544,396263,12722,132472,251790,26122,127938,1591454,105423,2125,248,5090,97,57,331675,420187,256124,178044,89306,64117,5224,1344677,457814,1802491,1074754,375372,253998,2228
233,BIHAR,Kaimur (Bhabua),1626384,847006,779378,920276,549923,370353,28264,125070,268597,24880,92616,1456229,155283,1407,296,7707,129,1534,318859,294927,210899,147315,86815,70169,9576,1138560,551317,1689877,1039302,353413,226808,6861
234,BIHAR,Rohtas,2959918,1543546,1416372,1799832,1061783,738049,15251,218087,405544,48512,252736,2645415,300487,2889,2569,1584,252,537,535187,548971,399053,333053,194928,161555,16006,2188753,876443,3065196,1875174,673742,407193,3809
235,BIHAR,Aurangabad,2540073,1318684,1221389,1466002,868733,597269,533,178525,426096,40652,192497,2291133,237353,2218,295,334,775,19,559512,482199,302662,253142,136783,91371,8329,1833998,784131,2618129,1626969,564571,340948,7585
236,BIHAR,Gaya,4391418,2266566,2124852,2297613,1368803,928810,1463,370759,783505,87178,422620,3876395,488121,3943,913,870,1723,108,902272,757690,447480,342254,191824,131163,12047,2784730,1953368,4738098,2810026,936630,537333,107429
237,BIHAR,Nawada,2219146,1144668,1074478,1091012,659474,431538,1048,216400,397505,40018,163118,1964620,244394,1299,250,176,279,80,601011,368649,195072,161127,95943,64585,3130,1489517,1091439,2580956,1440781,485628,288805,3932
238,BIHAR,Jamui,1760405,916064,844341,858588,534385,324203,38608,156491,331466,105637,133977,1525746,217621,8443,162,159,87,3438,420472,317612,153973,104211,56137,29633,3439,1085477,765297,1850774,1135919,392052,227016,5418
239,BIHAR,Jehanabad,1125313,585582,539731,618881,374412,244469,618,86108,179519,15075,84676,1045117,75742,691,148,248,60,58,211761,165906,117558,112966,68748,45519,3539,725997,495877,1221874,714244,254582,155106,1381
240,BIHAR,Arwal,700843,363497,337346,386351,235279,151072,307,49127,144698,6758,35771,634099,64259,390,59,323,74,60,123288,118311,80704,81975,48822,27945,1435,482480,290095,772575,444448,156031,98550,1814
241,SIKKIM,North  District,43709,24730,18979,30450,18579,11871,13974,7313,2262,332,13452,14883,815,2660,816,23318,35,921,6030,8276,6181,3223,1993,1406,273,27382,7673,35055,27099,11674,4887,49
242,SIKKIM,West District,136435,70238,66197,93432,51988,41444,28332,40797,8053,1403,20095,75286,965,13002,40,36390,20,10477,30518,30827,19973,10005,6439,4831,527,103120,28227,131347,84209,32520,19400,306
243,SIKKIM,South District,146850,76670,70180,106741,59357,47384,19836,37802,4188,1004,31759,84583,1889,21462,151,35053,45,3176,24507,32427,22340,12415,7260,5766,488,105203,24395,129598,87982,37318,20982,568
244,SIKKIM,East District,283583,151432,132151,214329,121345,92984,38957,31489,11483,2404,94302,177910,6198,23398,861,72455,214,1726,33578,53789,45602,29215,19258,20904,2682,205028,38142,243170,165520,80354,37456,253
245,ARUNACHAL PRADESH,Tawang,49977,29151,20826,26073,17720,8353,18041,7631,1581,114,19235,11842,787,776,1164,34920,72,349,4904,4730,4029,2140,1989,1379,667,19838,19203,39041,30709,13849,5399,20
246,ARUNACHAL PRADESH,West Kameng,83947,46155,37792,48492,29566,18926,23609,14476,1705,801,25511,31265,1970,8466,328,36087,71,5556,8836,10317,8428,5633,3987,2693,299,40193,25606,65799,53026,22362,8493,66
247,ARUNACHAL PRADESH,East Kameng,78690,38775,39915,38449,21599,16850,37134,21835,1063,273,8539,12333,652,37136,36,452,23,27868,11713,10487,8852,6213,4510,2330,142,44247,31763,76010,53752,17922,6960,56
248,ARUNACHAL PRADESH,Papum Pare,176573,89182,87391,121048,65794,55254,60747,14104,1859,1543,48266,57027,6148,84397,310,4768,139,22586,15368,21956,21376,20007,17342,13840,926,110815,30360,141175,120592,43812,11856,313
249,ARUNACHAL PRADESH,Upper Subansiri,83448,41758,41690,45278,24807,20471,39753,21690,1846,481,9353,13474,521,8779,28,297,11,59449,10219,16118,15339,10348,8017,4276,473,64790,28364,93154,56054,20055,7230,109
250,ARUNACHAL PRADESH,West Siang,112274,58168,54106,64746,36777,27969,47037,28852,1384,298,18643,15881,2218,29969,577,3311,49,60005,14227,17675,15908,11441,8418,6030,521,74220,27956,102176,70415,28305,13469,85
251,ARUNACHAL PRADESH,East Siang,99214,50116,49098,62576,34210,28366,35446,20185,3565,493,15979,27854,2289,18254,69,776,30,49393,9938,13713,13968,10937,9498,6540,525,65119,21543,86662,61993,25334,11802,85
252,ARUNACHAL PRADESH,Upper Siang,35320,18699,16621,18195,10723,7472,14055,9976,804,591,6273,5261,411,5643,27,2577,7,20967,3952,5584,4915,2935,2211,1349,46,20992,11209,32201,21090,8910,5252,68
253,ARUNACHAL PRADESH,Changlang,148226,76948,71278,73174,44027,29147,26817,39732,4208,496,18530,47683,2134,35969,94,50381,95,11738,20425,22537,17354,10032,5641,3633,834,80456,57290,137746,96630,35018,16414,164
254,ARUNACHAL PRADESH,Tirap,111975,57604,54371,47974,29313,18661,49007,35967,1811,836,11555,20682,1103,83361,61,778,43,5325,13585,16989,12077,7834,4305,2134,182,57106,50628,107734,71785,25669,14423,98
255,ARUNACHAL PRADESH,Lower Subansiri,83030,41843,41187,54057,29470,24587,37108,13656,1968,435,14143,9551,1482,34402,27,193,13,37085,8492,10821,11661,9861,7674,5230,295,54034,17273,71307,55258,20305,7412,55
256,ARUNACHAL PRADESH,Kurung Kumey,92076,45318,46758,36606,20258,16348,46305,27417,2947,833,6847,4859,471,51189,43,121,81,34158,12661,15054,12264,6997,4353,2031,299,53659,42621,96280,64379,20713,6836,148
257,ARUNACHAL PRADESH,Dibang Valley,8004,4414,3590,4436,2614,1822,2851,1290,106,68,2091,3141,111,223,7,126,2,4267,696,1258,1060,809,656,356,91,4926,2185,7111,5113,2088,786,17
258,ARUNACHAL PRADESH,Lower Dibang Valley,54080,28053,26027,31849,18087,13762,13325,9687,3354,233,9052,28915,2247,9213,33,2932,19,10393,5875,7957,7351,5508,3570,2795,85,33141,14406,47547,35140,13254,5652,34
259,ARUNACHAL PRADESH,Lohit,145726,76221,69505,83062,48380,34682,23953,29909,7789,786,22461,99020,3846,10684,210,24452,104,7277,19306,25179,20643,13070,7612,5180,584,91574,52421,143995,94890,35493,15195,148
260,ARUNACHAL PRADESH,Anjaw,21167,11507,9660,9990,6523,3467,8243,6316,181,84,3920,13088,655,271,273,644,12,6137,2879,2946,2170,1167,793,502,98,10555,8723,19278,13913,4755,2456,43
261,NAGALAND,Mon,250260,131753,118507,119626,67432,52194,113942,113473,10836,1608,21737,8102,3444,236494,84,1256,314,1,37431,46055,30500,7628,3565,1772,107,127058,130529,257587,168773,53600,27437,450
262,NAGALAND,Mokokchung,194622,101092,93530,159494,83479,76015,87864,48925,9166,3798,38178,9840,2057,181847,78,442,66,6,20259,43483,54035,27425,13077,10299,870,169448,22555,192003,111243,52853,30363,163
263,NAGALAND,Zunheboto,140757,71217,69540,102881,53504,49377,68490,44723,11955,2025,20763,2580,772,136995,39,286,6,2,16523,30889,35113,17282,8821,5560,1107,115295,25988,141283,91709,32267,16730,51
264,NAGALAND,Wokha,166343,84505,81838,128208,67385,60823,77805,47473,6438,1965,22536,5605,2043,158236,34,318,8,20,15865,37024,41627,18746,10223,8030,401,131916,25048,156964,106951,40510,18811,71
265,NAGALAND,Dimapur,378811,197394,181417,278037,150142,127895,113097,24517,8990,5073,112770,108900,31212,234239,566,1270,2148,157,34539,61815,80076,44343,26712,27532,2939,277956,58926,336882,243392,98601,36618,200
266,NAGALAND,Phek,163418,83743,79675,105893,57926,47967,77610,55091,3159,1275,20752,3563,950,158224,31,350,17,198,22494,32722,30434,12785,7268,5926,481,112110,44456,156566,108514,37842,16969,93
267,NAGALAND,Tuensang,196596,101933,94663,117511,63653,53858,92704,75212,3913,1104,17925,2979,1052,191864,27,572,5,1,29602,40900,33514,15013,6008,2760,116,127913,66450,194363,134573,43210,18762,51
268,NAGALAND,Longleng,50484,26502,23982,29859,16139,13720,23347,22501,1309,598,6160,873,635,48849,5,77,0,0,7986,11884,8672,3458,1695,595,15,34305,18230,52535,33970,11210,5271,33
269,NAGALAND,Kiphire,74004,37830,36174,41232,22675,18557,35212,21432,1259,749,8519,1040,564,71803,13,210,1,1,11197,15740,13645,5204,2052,997,76,48911,32120,81031,52699,14955,6309,41
270,NAGALAND,Kohima,267988,138966,129022,197489,107038,90451,114121,44684,2198,2072,65871,25496,4384,234955,998,1519,80,335,21654,46756,57726,30518,19855,23439,1770,201718,45802,247520,173701,68485,25557,245
271,NAGALAND,Peren,95219,49714,45505,62204,34584,27620,40754,39671,3739,2571,15409,4076,1850,86145,15,459,10,2493,9248,24527,20732,8082,3938,2169,75,68771,24790,93561,64393,21597,9156,73
272,MANIPUR,Senapati,479148,247323,231825,264477,148012,116465,204691,175127,30369,4978,42307,43833,1649,426819,140,2409,53,1243,46757,81735,91395,62033,40438,24940,598,347896,191001,538897,314439,111516,52008,1185
273,MANIPUR,Tamenglong,140651,72371,68280,85006,47403,37603,66400,48849,1924,1710,18192,2995,589,134760,59,425,57,1144,11155,28461,26794,17867,11645,7102,270,103294,45317,148611,90273,33290,16924,164
274,MANIPUR,Churachandpur,274143,138820,135323,195935,104013,91922,128459,64834,8282,5067,44472,12034,2886,254979,152,495,87,2333,32860,67907,65475,38567,23284,14523,509,243125,57561,300686,168608,67802,37096,637
275,MANIPUR,Bishnupur,237399,118782,118617,156333,87313,69020,1662,34358,15109,11567,48903,175102,18691,4264,56,76,16,38457,15941,36011,50004,31775,20077,20074,1440,175322,67610,242932,135220,62907,38815,457
276,MANIPUR,Thoubal,422168,210845,211323,269304,152617,116687,879,77331,33106,21017,63865,267146,107323,4322,106,114,24,42347,32396,69738,87932,55803,37899,28550,3214,315532,118088,433620,251975,107196,62060,937
277,MANIPUR,Imphal West,517992,255054,262938,392626,205985,186641,12601,37107,12870,19918,143492,387497,24298,23377,589,1891,1264,77032,32811,66042,104229,77472,60821,81876,9564,432815,87248,520063,278940,148146,89394,1512
278,MANIPUR,Imphal East,456113,226094,230019,324664,173314,151350,14157,36355,20250,21826,116417,274906,80199,27361,181,639,62,70825,38436,69144,99202,60422,47390,50647,4102,369343,90250,459593,261530,123439,70005,1139
279,MANIPUR,Ukhrul,183998,94718,89280,129829,70148,59681,85636,56815,3852,2233,25029,7553,1115,174112,108,635,70,32,20670,29382,38350,31734,22729,15636,405,158906,42156,201062,113715,43646,25165,1472
280,MANIPUR,Chandel,144182,74579,69603,90302,51053,39249,64658,43255,8315,3040,21628,10810,3086,129049,136,400,59,354,17382,28163,30589,18971,12213,8105,240,115663,38191,153854,86255,39324,18329,274
281,MIZORAM,Mamit,86364,44828,41536,60191,32977,27214,40005,28669,2553,262,7855,2989,1782,69104,13,12328,25,19,9328,19711,19949,10756,3180,1771,22,64717,20091,84808,55914,20082,10318,50
282,MIZORAM,Kolasib,83955,42918,41037,65895,34147,31748,36692,17992,5921,585,12174,4000,4426,75210,16,108,2,46,11367,18046,20399,9849,3473,2530,62,65726,14217,79943,52147,20576,11167,65
283,MIZORAM,Aizawl,400309,199270,201039,340595,169547,171048,191025,39266,11434,3360,120576,13249,5264,379134,105,1570,76,505,29332,68214,100103,78752,37701,31310,2058,347470,38248,385718,235892,108094,56092,231
284,MIZORAM,Champhai,125745,63388,62357,100802,51440,49362,61512,38336,5823,980,15203,1075,699,123446,9,151,45,194,14491,31359,30454,16259,4956,4087,78,101684,15449,117133,78778,29690,17189,88
285,MIZORAM,Serchhip,64937,32851,32086,54476,27598,26878,31508,21804,1284,926,8383,991,335,63444,6,60,9,35,8771,14985,16237,9062,2915,2128,35,54133,5963,60096,39568,15894,9404,71
286,MIZORAM,Lunglei,161428,82891,78537,121122,64515,56607,76353,45439,10662,813,21378,5231,1290,127124,74,27543,93,5,22181,33313,34774,19918,8503,5509,116,124314,32451,156765,100250,39690,21424,64
287,MIZORAM,Lawngtlai,117894,60599,57295,62861,36444,26417,55310,29189,3153,613,12611,1668,522,63892,52,51549,122,2,19890,21114,16629,10538,3763,2515,125,74574,54874,129448,80723,25303,11831,37
288,MIZORAM,Saiha,56574,28594,27980,42233,21861,20372,27416,8908,957,313,9283,933,514,54977,11,102,4,2,8422,14151,12130,7269,3628,2204,69,47873,8787,56660,37127,12784,6636,27
289,TRIPURA,West Tripura,1725739,879428,846311,1361354,722998,638356,214666,115175,156108,25163,401732,1512801,152791,53622,499,2128,362,430,248343,421485,451563,156277,88122,85405,13478,1464673,279053,1743726,940424,499719,284637,959
290,TRIPURA,South Tripura,876001,447544,428457,646810,351082,295728,171661,85530,111332,6375,163608,736015,49258,39258,245,49420,106,808,129846,223185,204201,70173,31690,26870,5160,691125,188363,879488,505558,236676,133424,343
291,TRIPURA,Dhalai,378230,194544,183686,276217,151643,124574,103849,45956,42201,2870,64804,307120,8256,22940,175,39120,85,206,64515,84516,74015,21430,9157,6425,890,260948,109130,370078,232286,95548,50269,127
292,TRIPURA,North Tripura,693947,352860,341087,520402,275646,244756,88310,49286,43977,7088,148316,507967,105737,44062,151,34717,307,70,129329,179547,158211,47160,22720,18419,3736,559122,156840,715962,414878,178608,100274,187
293,MEGHALAYA,West Garo Hills,643291,324159,319132,358702,193438,165264,237237,120740,39725,7643,87585,122936,106788,389956,209,3392,144,16950,85733,129178,90963,70941,29404,10856,3547,420622,208900,629522,427629,143604,70599,1459
294,MEGHALAYA,East Garo Hills,317917,161223,156694,192147,102513,89634,151319,77390,19246,2475,26962,17272,3359,289708,56,1004,38,5617,51578,70679,52762,31328,9473,2484,298,218602,100781,319383,216742,70424,29926,825
295,MEGHALAYA,South Garo Hills,142334,73170,69164,82062,45003,37059,66097,28145,5565,1249,18110,7036,1050,132984,27,332,10,362,25906,28921,21506,13858,3998,826,831,95846,44849,140695,97082,30605,14495,152
296,MEGHALAYA,West Khasi Hills,383461,193715,189746,230678,117307,113371,185963,84956,37184,2475,38730,6498,1533,366881,58,1313,38,5878,80318,78208,45046,28417,12295,6450,541,251275,133244,384519,278569,69988,33431,1473
297,MEGHALAYA,Ribhoi,258840,132531,126309,155859,80977,74882,114174,55833,19989,1676,28975,30945,1838,218508,166,428,49,6308,57680,58581,31103,20134,7632,3911,633,179674,78974,258648,183343,52945,22365,187
298,MEGHALAYA,East Khasi Hills,825922,410749,415173,578030,287270,290760,341110,76767,40889,2966,206164,144935,14185,543394,2495,3111,303,115597,118135,163729,127722,94579,58836,61639,9397,634037,168575,802612,545961,192428,86576,957
299,MEGHALAYA,Jaintia Hills,395124,196285,198839,187527,87371,100156,190233,50844,35766,2004,65566,12456,1646,271596,34,284,45,107559,67749,61526,34677,26748,13544,8039,2934,215217,165184,380401,291097,72934,30362,731
300,ASSAM,Kokrajhar,887142,452905,434237,489305,275220,214085,139086,156753,56330,12423,115625,529068,252271,101091,93,1718,396,123,116899,166013,154715,78788,39571,17287,2733,576006,340601,916607,552671,224715,108956,800
301,ASSAM,Dhubri,1949258,997848,951410,922341,511551,410790,3134,205305,171116,27822,265576,388380,1553023,4107,254,101,1846,45,253638,299724,250242,100387,65082,34401,3863,1007337,992068,1999405,1286592,439375,221745,1546
302,ASSAM,Goalpara,1008183,513292,494891,563577,304302,259275,115557,126549,75828,14346,145850,347878,579929,77862,771,194,477,103,124700,213510,183904,73683,39885,18294,3464,657440,375071,1032511,650509,239831,117427,416
303,ASSAM,Barpeta,1693622,867004,826618,897058,499038,398020,13814,205259,98946,30342,227277,492966,1198036,1020,112,49,399,14,210607,307884,300845,121924,87377,46947,8007,1083591,664161,1747752,1072312,405046,215355,909
304,ASSAM,Morigaon,957423,486651,470772,539902,289698,250204,68395,157612,75984,14346,103206,451882,503257,834,113,65,244,11,130091,195656,179810,67969,40803,18462,2791,635582,351756,987338,612737,225224,118271,1191
305,ASSAM,Nagaon,2823768,1439112,1384656,1710716,921850,788866,57394,346123,196174,38122,399579,1225246,1563203,26844,3036,1073,1162,61,392616,638088,576214,199792,115864,66994,10351,1999919,873197,2873116,1778277,678034,366112,1345
306,ASSAM,Sonitpur,1924110,983904,940206,1108572,620525,488047,114522,249123,114865,25719,380899,1422824,350536,138166,1363,5088,1003,221,216097,416218,377653,141373,90385,49901,6412,1298039,627141,1925180,1159991,501239,261648,1232
307,ASSAM,Lakhimpur,1042137,529674,512463,683486,375552,307934,122710,239377,43922,10983,135713,797130,193476,46217,412,1074,250,2410,126950,212080,217497,107326,82885,44212,4731,795681,275677,1071358,639385,268872,133615,265
308,ASSAM,Dhemaji,686133,351249,334884,423028,237761,185267,160111,231937,19181,7224,58458,655052,13475,8711,297,911,167,6315,79107,138838,136371,80804,55399,28006,2868,521393,194984,716377,434221,169630,82051,231
309,ASSAM,Tinsukia,1327929,680231,647698,798322,453449,344873,40297,149482,47756,13241,346717,1181347,48373,76877,1999,16228,837,395,150893,266717,276292,109805,61040,38152,7353,910252,417081,1327333,799874,352158,175377,520
310,ASSAM,Dibrugarh,1326335,676434,649901,884531,491361,393170,51036,135194,61209,14362,349792,1198401,64526,52968,2261,4673,1055,46,143189,243607,301287,139813,89500,59380,6984,983760,340744,1324504,767147,371864,186774,550
311,ASSAM,Sivasagar,1151050,589216,561834,813505,444767,368738,24050,138100,48468,14532,284617,1007277,95553,33147,902,3953,286,8541,115378,208891,280517,158118,96939,53437,5554,918834,247114,1165948,648056,330947,171710,337
312,ASSAM,Jorhat,1092256,556805,535451,794929,432335,362594,69176,145885,53153,31543,268037,1008219,54684,21051,1540,2378,719,578,99454,201680,295444,128050,97025,62608,8433,892694,209170,1101864,604908,315550,171062,736
313,ASSAM,Golaghat,1066888,543161,523727,721764,396475,325289,55345,190590,66616,15068,207654,917426,90312,50582,1131,3863,530,1347,117393,223902,261192,111145,66197,36887,4084,820800,258897,1079697,629153,289085,148244,406
314,ASSAM,Karbi Anglong,956313,490167,466146,557214,314253,242961,266278,223020,60952,9861,89608,766000,20290,157789,370,6260,397,3568,109324,212224,199289,93137,40602,18225,3426,676227,310093,986320,618633,233739,103123,818
315,ASSAM,Dima Hasao,214102,110802,103300,140873,78559,62314,75323,44480,4818,1492,34238,143593,4358,63310,207,680,70,1170,20780,43811,53736,27839,10859,5565,598,163188,57631,220819,135463,53699,24830,110
316,ASSAM,Cachar,1736617,886284,850333,1174128,639946,534182,8833,120356,68664,24466,394576,1038985,654816,37635,280,341,1673,98,256855,447993,379469,156156,79766,45341,12951,1378531,357907,1736438,1048990,444899,241776,952
317,ASSAM,Karimganj,1228686,625864,602822,795297,435942,359355,946,94348,67033,17435,220355,521962,692489,11990,114,446,524,110,198059,333885,257931,76685,39637,21408,7903,935508,303785,1239293,779850,284368,163990,478
318,ASSAM,Hailakandi,659296,337890,321406,407366,226836,180530,337,65673,31248,7313,110006,251194,397653,8480,84,490,247,636,88596,177984,139029,50056,28504,11608,4265,500042,173306,673348,419921,156243,82841,291
319,ASSAM,Bongaigaon,738804,375818,362986,434078,237114,196964,9458,83442,47406,9485,115473,359145,371033,5924,384,236,871,9,93591,138294,133643,55924,35491,20221,2267,479431,260721,740152,458796,184849,94939,220
320,ASSAM,Chirang,482162,244860,237302,259902,145869,114033,89415,80328,35224,7672,70670,320647,109248,49747,87,406,125,482,64999,92943,84682,37792,17702,6594,918,305630,172939,478569,301518,122244,58282,118
321,ASSAM,Kamrup,1517542,778461,739081,995319,550219,445100,89944,185803,99522,69106,274523,877495,601784,33297,319,185,1330,55,163849,290097,353861,154831,118849,55011,6444,1142942,392678,1535620,895775,408232,212740,795
322,ASSAM,Kamrup Metropolitan,1253938,647585,606353,1001191,537227,463964,37219,25250,16995,12463,436224,1064412,151071,18810,3679,1627,9250,170,79177,160490,255522,148429,143478,167972,30795,985863,128773,1114636,659453,401500,190908,2077
323,ASSAM,Nalbari,771639,396006,375633,531771,293184,238587,11672,58070,34984,19302,155267,491582,277488,429,62,27,1004,9,75866,141690,192771,81507,71734,39368,3693,606629,188960,795589,442061,211320,117809,449
324,ASSAM,Baksa,950075,481330,468745,572837,322614,250223,165373,149288,94591,20310,142567,782901,135750,27076,156,1189,239,353,95444,195643,225635,96782,53446,15422,1839,684211,294784,978995,563089,256282,130083,621
325,ASSAM,Darrang,928500,475273,453227,487039,268666,218373,4119,129456,81617,10542,103228,327322,597392,1688,431,57,724,19,119027,163277,161153,59039,47398,22267,3079,575240,375556,950796,583436,226525,118102,437
326,ASSAM,Udalguri,831668,421617,410051,469926,264326,205600,133822,124824,72744,11801,135661,612425,105319,110215,215,1681,124,229,101146,155720,162369,63394,34334,14001,1612,532576,306833,839409,499214,221518,109962,974
327,WEST BENGAL,Darjiling,1846823,937259,909564,1315585,717673,597912,200138,76178,66041,16579,524928,1366681,105086,141848,2032,209240,1840,15523,183479,344865,402415,176129,113905,110193,12851,1343837,415353,1759190,1031221,523288,289979,2335
328,WEST BENGAL,Jalpaiguri,3872846,1983064,1889782,2498780,1396622,1102158,365836,214932,349672,30090,918216,3156781,445817,186279,2994,50676,1461,23816,455854,765613,814395,292056,150360,129393,18916,2626587,1203423,3830010,2259507,1035449,575667,2223
329,WEST BENGAL,Koch Bihar,2819086,1451542,1367544,1850504,1028733,821771,8737,364797,391875,40593,330712,2087766,720033,4122,449,445,1869,158,393492,595555,590626,209153,93119,81100,8712,1971757,873135,2844892,1623320,744646,448761,2359
330,WEST BENGAL,Uttar Dinajpur,3007134,1551066,1456068,1489667,853495,636172,80985,257377,442328,37978,337943,1482943,1501170,16702,477,432,1324,1622,402590,488047,422777,163106,73395,59457,12723,1622095,1431264,3053359,1916033,704859,385155,1087
331,WEST BENGAL,Dakshin Dinajpur,1676276,857199,819077,1083685,596474,487211,137341,193276,279932,32290,197489,1232850,412788,24794,276,148,323,2786,247675,323965,327064,135556,63286,52345,5190,1155081,534394,1689475,937283,465982,271423,1588
332,WEST BENGAL,Maldah,3988845,2051541,1937304,2086432,1152019,934413,156456,255182,545759,196687,540219,1914352,2045151,13209,747,359,639,7929,478902,629137,595551,238078,109719,92207,18330,2161924,1960034,4121958,2511004,955283,520122,2436
333,WEST BENGAL,Murshidabad,7103807,3627564,3476243,4055834,2177187,1878647,44872,381076,842294,466007,900530,2359061,4707573,18102,766,348,3037,7429,837828,1428661,1210859,443254,230242,170051,25975,4346870,3031841,7378711,4390564,1717594,991413,4236
334,WEST BENGAL,Birbhum,3502404,1790920,1711484,2158447,1201481,956966,122697,227254,611510,65062,427777,2181515,1298054,10906,582,258,1152,6051,417769,661190,622372,245201,122865,115743,15205,2200345,1346802,3547147,2008655,952059,539463,2227
335,WEST BENGAL,Barddhaman,7717563,3966889,3750674,5247208,2918040,2329168,245866,342166,973182,124558,1471345,6008472,1599764,21220,16675,1602,1674,44968,800473,1437198,1605634,698251,405935,439823,62616,5449930,2196886,7646816,4149420,2265543,1292913,9687
336,WEST BENGAL,Nadia,5167600,2653768,2513832,3480555,1878866,1601689,69558,308742,556134,169138,808593,3728482,1382682,33835,849,514,281,16893,605490,1093403,1052487,412193,236828,209562,25491,3635454,1570127,5205581,2745828,1484986,934417,2369
337,WEST BENGAL,North Twenty Four Parganas,10009781,5119389,4890392,7608693,4056046,3552647,130418,288058,599039,155762,2528765,7352769,2584684,26933,9394,5818,4452,2930,1090829,1874051,2094743,989053,670977,852923,127926,7700502,1901634,9602136,5104876,2968996,1921143,14766
338,WEST BENGAL,Hugli,5519145,2814653,2704492,4078388,2211777,1866611,115994,259680,583380,111828,1197982,4574569,870204,7300,2662,1730,2160,49050,676265,1172797,1174912,515807,333658,380060,44252,4297751,1180806,5478557,2766489,1688206,1060821,3629
339,WEST BENGAL,Bankura,3596674,1838095,1758579,2232992,1299337,933655,185223,309723,647374,61386,447737,3033581,290450,3865,386,260,2904,260694,450029,545200,686924,261478,143882,133465,20379,2241357,1417787,3659144,1942335,1014764,637834,1741
340,WEST BENGAL,Puruliya,2930115,1496996,1433119,1624905,1002058,622847,268849,268800,492205,87560,401077,2373120,227249,8646,622,209,3052,309029,299355,480046,528068,177459,91807,77621,10072,1664428,1272799,2937227,1678057,764776,484166,3116
341,WEST BENGAL,Haora,4850029,2500819,2349210,3605206,1942824,1662382,7333,80575,181662,297774,1259834,3535844,1270641,8666,4380,1258,9699,1265,516323,1059842,1084155,446743,284481,304594,37027,3733165,926661,4659826,2587164,1423304,833104,6457
342,WEST BENGAL,Kolkata,4496694,2356766,2139928,3588137,1926915,1661222,4955,16039,12388,68438,1698875,3440290,926414,39758,13849,4771,21178,1452,255171,597841,820902,555529,425245,691804,89701,3436193,410988,3847181,2025389,1433314,1014769,23222
343,WEST BENGAL,South Twenty Four Parganas,8161961,4173778,3988183,5531657,3043277,2488380,47781,355350,806562,240976,1561606,5155545,2903075,66498,2783,2494,972,6065,1119126,1775793,1657528,564417,316571,322157,46568,5802160,2184508,7986668,4763943,2151474,1235558,10986
344,WEST BENGAL,Paschim Medinipur,5913457,3007885,2905572,4078412,2266913,1811499,440184,572268,1105201,142602,689088,5056953,620554,23287,2854,2019,1550,184278,831300,1139784,1289873,477973,262072,211437,35396,4247835,1689984,5937819,3243971,1664250,990179,15057
345,WEST BENGAL,Purba Medinipur,5095875,2629834,2466041,3923194,2149073,1774121,13756,345215,702304,118816,743985,4343972,743436,2648,746,317,574,359,776367,1219166,1289927,444668,236549,184225,30677,4181579,1021541,5203120,2866678,1384242,842025,2930
346,JHARKHAND,Garhwa,1322784,683575,639209,653476,405161,248315,101375,113561,328673,14487,114710,1104475,194680,17168,123,371,20,4591,207665,195565,147446,87844,46882,28144,2830,716376,557852,1274228,860869,284036,177599,280
347,JHARKHAND,Chatra,1042886,533935,508951,510061,303902,206159,22422,119297,188513,14210,75670,903179,116710,6565,888,35,129,12936,200861,161729,102033,63670,35342,21697,2046,587378,467975,1055353,692650,222892,126682,662
348,JHARKHAND,Kodarma,716259,367222,349037,390249,238780,151469,3309,83126,64275,7934,102083,605138,107018,1221,944,32,980,269,129677,130315,80561,52622,26415,20907,2374,442871,297992,740863,462098,158603,95309,249
349,JHARKHAND,Giridih,2445474,1258098,1187376,1253475,783736,469739,117542,369913,362610,32544,271210,1856202,508586,14645,937,650,1503,59218,503261,443980,261309,146464,77540,55122,8449,1496125,1047685,2543810,1597269,533788,312967,1450
350,JHARKHAND,Deoghar,1492073,775022,717051,793538,489837,303701,89950,128656,209693,39361,173757,1165140,302626,6027,143,188,282,16067,217460,266292,190171,96331,54419,43979,6699,875351,635544,1510895,944961,338413,205514,3185
351,JHARKHAND,Godda,1313551,677927,635624,604519,376212,228307,140698,144603,307767,18719,81102,937126,289182,37795,97,128,115,47067,217607,190777,126766,79430,47395,30870,4002,696847,653464,1350311,820367,308639,183519,1026
352,JHARKHAND,Sahibganj,1150567,589391,561176,483263,287303,195960,154908,109975,206902,43179,130146,628044,398243,83208,198,245,125,38426,146399,171416,110822,52248,28087,19832,2593,531397,637296,1168693,745027,261849,137727,5964
353,JHARKHAND,Pakur,900422,452661,447761,352881,206989,145892,192087,105334,150028,19471,129751,410127,322963,75865,356,283,222,88760,100367,133770,79045,29934,15700,9822,1525,370163,548434,918597,587976,206826,104418,1202
354,JHARKHAND,Dhanbad,2684487,1405956,1278531,1722204,1014950,707254,115863,97118,103488,25889,618009,2149480,431762,11243,9727,331,1268,77182,317918,501453,449506,305054,186697,107382,14615,1882625,662522,2545147,1634835,648876,356445,44331
355,JHARKHAND,Bokaro,2062330,1072807,989523,1273520,759088,514432,126393,137521,126406,21671,399770,1636460,241451,13730,4174,1890,2045,160524,242467,338861,342646,232434,154076,116396,21157,1448037,595924,2043961,1261238,510375,282115,8602
356,JHARKHAND,Lohardaga,461790,232629,229161,259707,149568,110139,131920,99780,80840,4449,36263,112378,95012,16770,51,33,15,235987,82873,84920,63545,38503,21987,13847,976,306651,188323,494974,298844,100340,62244,362
357,JHARKHAND,Purbi Singhbhum,2293919,1176902,1117017,1507699,856526,651173,327934,112059,209802,21438,493868,1550178,203999,30172,38544,892,1670,465367,202047,346644,369670,278853,162210,157688,25048,1542160,525916,2068076,1292595,632314,368148,862
358,JHARKHAND,Palamu,1939869,1006302,933567,1024563,621706,402857,88631,133585,380976,19911,178703,1683169,238295,6164,734,188,284,5681,303053,296937,231565,160964,100290,63595,7117,1163521,803424,1966945,1244572,425668,268387,1242
359,JHARKHAND,Latehar,726978,369666,357312,350682,209706,140976,164669,103693,142729,9205,57752,473049,69808,47653,120,128,16,133525,109491,121529,88787,46142,23885,13956,1017,404807,349277,754084,484084,152720,89870,304
360,JHARKHAND,Hazaribagh,1734495,890881,843614,1013249,596113,417136,60972,242460,172385,16150,223641,1397227,281247,17137,1312,71,1676,34154,253962,322344,255576,173378,99945,79898,6512,1191615,613774,1805389,1107452,396466,230033,544
361,JHARKHAND,Ramgarh,949443,494230,455213,596497,350031,246466,99265,90770,46815,8336,166204,774251,129037,7260,5093,69,537,32378,115199,138748,134324,101381,70249,47207,5397,612505,292062,904567,594747,230525,123794,377
362,JHARKHAND,Dumka,1321442,668514,652928,672409,406275,266134,288952,193402,303084,23106,105187,1044726,106865,86404,234,267,162,78622,229157,229259,149009,69525,38383,25593,2697,743623,601078,1344701,799323,324226,196164,1729
363,JHARKHAND,Jamtara,791042,404830,386212,426312,258260,168052,120454,106008,135667,11547,73409,550560,164406,4419,520,118,783,68564,131150,132014,85745,40613,22995,14802,1578,428897,366012,794909,480895,189889,116810,3448
364,JHARKHAND,Ranchi,2914253,1494937,1419316,1911433,1085244,826189,521434,317487,267360,38452,519568,1612239,410759,193974,4826,932,2733,677445,361522,547583,495515,370847,247237,195181,28424,2246309,613855,2860164,1742293,725938,409166,36856
365,JHARKHAND,Khunti,531885,266335,265550,284575,164741,119834,195916,166290,49448,9245,35001,138863,13122,136438,69,245,148,241292,64029,89730,89924,48591,20689,10130,537,323630,177856,501486,327152,125649,78736,348
366,JHARKHAND,Gumla,1025213,514390,510823,559720,321795,237925,354240,321272,97918,12771,55547,309563,51429,202449,221,531,23,457468,136719,242580,182260,82114,45613,23742,2913,715941,322119,1038060,643579,225871,155452,311
367,JHARKHAND,Simdega,599578,300309,299269,343483,191991,151492,212861,158019,90232,8011,32383,201524,15103,306601,51,753,114,73930,82317,130068,97580,47836,24842,13674,1197,397514,191341,588855,357859,143560,97817,342
368,JHARKHAND,Pashchimi Singhbhum,1502338,749385,752953,727561,439273,288288,510347,244172,267475,24825,158391,423937,38103,87587,946,389,52,945864,290007,461276,202752,79516,35824,10743,574,1080692,279016,1359708,960987,353305,187635,411
369,JHARKHAND,Saraikela-Kharsawan,1065056,544411,520645,612993,365332,247661,187493,116731,142966,10251,160103,709016,63588,8113,1114,187,72,280469,134506,259984,177763,106348,49944,29840,1443,759828,228943,988771,634975,265892,161542,2647
370,ORISSA,Bargarh,1481255,749161,732094,983783,557217,426566,140593,216413,360650,48145,136884,1459065,7527,11744,652,161,125,44,205253,310784,247014,147217,58840,49238,8133,1026479,442733,1469212,787033,410005,282422,1795
371,ORISSA,Jharsuguda,579505,296690,282815,405879,228092,177787,88485,40867,56809,15836,134195,553587,12783,10462,1441,80,70,67,69122,101541,103622,70928,32909,22010,7932,408064,143508,551572,320156,159477,98555,1317
372,ORISSA,Sambalpur,1041099,526877,514222,703691,393192,310499,177696,86800,160798,59288,198954,964188,20120,50637,2506,310,86,1117,133005,185289,171876,108455,50705,45828,13071,708229,282248,990477,565700,286575,186726,2098
373,ORISSA,Debagarh,312520,158230,154290,197819,112649,85170,55274,42660,82490,8087,32198,296001,704,14518,53,102,7,409,47615,58231,54088,27415,13420,9041,1729,211539,108811,320350,176062,81789,53989,680
374,ORISSA,Sundargarh,2093437,1061147,1032290,1342322,750147,592175,535493,184273,253327,26970,408657,1532352,71391,385011,5713,710,721,89986,208100,350349,335380,243386,120373,94710,36590,1388888,660465,2049353,1188918,573238,324436,6845
375,ORISSA,Kendujhar,1801733,906487,895246,1052518,605119,447399,412951,198044,310075,21314,237081,1752694,27752,9141,2177,209,131,7372,214518,287402,289350,158035,70059,57762,13918,1091044,700661,1791705,1038890,472908,282751,7184
376,ORISSA,Mayurbhanj,2519738,1256213,1263525,1369397,794171,575226,749089,238772,568755,113808,302199,2113079,33706,15008,661,162,109,351714,283489,390037,385216,214921,92060,72847,17415,1455985,1094844,2550829,1449729,650135,414076,5798
377,ORISSA,Baleshwar,2320529,1185787,1134742,1621232,902359,718873,137930,288818,358214,28736,256939,2197709,94254,6434,237,111,201,18345,342192,470502,416510,267354,112392,105962,27493,1742405,628627,2371032,1303828,622575,390611,3515
378,ORISSA,Bhadrak,1506337,760260,746077,1094140,596269,497871,15067,155956,151377,14451,146815,1398543,104202,745,169,81,111,61,210736,391081,297270,177013,71815,67536,17449,1232900,323145,1556045,848660,393629,260486,3562
379,ORISSA,Kendrapara,1440361,717814,722547,1089265,579970,509295,4736,149264,143864,16544,157218,1386792,50247,1423,169,62,52,24,218444,357621,298557,203472,76449,75926,12507,1242976,294723,1537699,771284,374559,290894,3624
380,ORISSA,Jagatsinghapur,1136971,577865,559106,889027,481049,407978,3636,111320,110323,16357,165649,1086140,46929,1604,206,74,58,63,151737,251767,251332,185671,72703,70602,14001,997813,209984,1207797,577896,317148,238753,3174
381,ORISSA,Cuttack,2624470,1352760,1271710,2011469,1103033,908436,46308,138698,248298,51809,497560,2457729,141263,11985,1026,6276,1180,168,289414,545514,513039,328319,159456,181601,45279,2062622,472182,2534804,1372301,743090,499895,9184
382,ORISSA,Jajapur,1827192,926034,901158,1290455,706396,584059,75384,120881,186021,20938,224394,1725595,93642,1623,470,58,100,3073,261077,433653,330016,223657,96963,87623,19271,1452260,460953,1913213,1010147,479392,332706,4947
383,ORISSA,Dhenkanal,1192811,612593,580218,829910,464093,365817,81178,71230,163636,17312,183355,1185542,4805,727,124,366,39,139,188872,238599,193395,132002,53162,43064,10903,859997,341887,1201884,641697,326233,222398,2483
384,ORISSA,Anugul,1273821,655718,618103,869456,494425,375031,89623,107607,172414,35069,211430,1258684,7512,3383,812,226,36,971,180523,265782,204235,129226,58029,45588,16602,899985,347851,1247836,708493,347521,213517,4290
385,ORISSA,Nayagarh,962789,502636,460153,688362,392333,296029,29518,83022,120129,17557,122925,955754,5278,383,107,33,24,12,174904,227102,177180,90089,36951,33148,5685,745059,232558,977617,502136,262086,196994,1573
386,ORISSA,Khordha,2251673,1167137,1084536,1749936,957515,792421,55957,92662,116274,39471,543786,2147632,84060,12527,1264,475,476,434,276378,445785,436534,295099,177974,247498,66645,1945913,371244,2317157,1199521,653346,391701,7105
387,ORISSA,Puri,1698730,865380,833350,1291939,704857,587082,2889,172761,163942,25115,259858,1644905,46094,4239,193,243,94,302,251520,413605,364098,179086,84374,87000,15511,1395194,309790,1704984,888134,477430,328666,4500
388,ORISSA,Ganjam,3529031,1779218,1749813,2210050,1262652,947398,59756,284943,565448,56274,595107,3486059,13315,23975,590,174,170,76,518072,767140,508511,297490,121151,97147,31266,2340777,1055331,3396108,1980232,924756,613249,10794
389,ORISSA,Gajapati,577817,282882,294935,262537,153663,108874,161812,65062,153199,5370,70302,353160,1556,219482,53,2180,66,4,68405,76419,54787,36977,17084,12556,1882,268110,335821,603931,345387,144043,85072,3315
390,ORISSA,Kandhamal,733110,359945,373165,399786,233900,165886,202314,79221,162932,11946,101250,580300,2138,148895,82,290,47,23,108606,145604,108773,48856,21351,14962,2462,450614,287948,738562,436625,177471,117777,1237
391,ORISSA,Baudh,441162,221625,219537,271612,158648,112964,28002,63657,104685,11674,39441,438152,1007,522,24,5,11,7,74205,98316,67549,30799,12500,8124,1683,293176,146392,439568,253467,111571,75046,1078
392,ORISSA,Subarnapur,610183,311312,298871,398421,230393,168028,28398,74005,139413,18756,54487,605225,1566,2374,58,46,17,6,86120,139994,105846,65368,25556,16745,4881,444510,167244,611754,341561,153760,113450,1412
393,ORISSA,Balangir,1648997,830097,818900,927260,545672,381588,174675,166565,326416,28650,198970,1618175,7811,16271,565,467,2225,141,240180,298288,226728,116297,54694,42401,6810,985398,721389,1706787,904026,430011,310876,4084
394,ORISSA,Nuapada,610382,301962,308420,299383,180903,118480,105858,94692,149834,8641,52271,601092,4952,1778,724,76,905,22,64389,114394,73787,51886,19577,10131,4316,338480,316086,654566,344075,152681,112325,1301
395,ORISSA,Kalahandi,1576869,787101,789768,802036,484177,317859,228285,144991,436733,18453,151753,1555367,4975,11160,796,175,1225,220,213426,225468,172905,94044,40383,27385,6840,780451,765368,1545819,880160,415778,275533,5398
396,ORISSA,Rayagada,967911,471960,495951,407735,241959,165776,282865,99265,248175,9959,109723,874445,4607,84916,219,249,123,44,84956,97387,73210,46001,21439,17681,6306,346980,583140,930120,577569,245766,140825,3751
397,ORISSA,Nabarangapur,1220946,604812,616134,470379,286984,183395,346145,173086,328783,14409,94628,1178005,6753,32152,169,189,325,54,116468,155611,95988,44522,16463,11198,2282,442532,739190,1181722,745206,297552,171761,6427
398,ORISSA,Koraput,1379647,678809,700838,568090,340843,227247,360210,207194,290626,14416,181170,1294151,8850,68550,518,219,491,3384,158847,158653,98266,60589,32257,29000,10200,547812,770707,1318519,818578,348803,207206,5060
399,ORISSA,Malkangiri,613192,303624,309568,244706,147001,97705,182897,151260,106353,7725,45328,600219,1871,10039,213,43,195,35,60913,64683,44962,19031,8487,5585,1202,204863,390356,595219,381913,146355,83284,1640
400,CHHATTISGARH,Koriya,658917,334737,324180,397823,229923,167900,151621,118498,94648,4830,89095,604259,25878,9398,1391,84,1155,15474,143413,109639,87969,47127,38677,26802,4134,457761,179639,637400,399581,165022,94073,241
401,CHHATTISGARH,Surguja,2359886,1193129,1166757,1187941,694686,493255,647829,465287,523356,12643,154521,2126195,81442,97432,2303,1287,623,48295,364452,338509,281260,135374,105992,64607,9524,1299718,991866,2291584,1441436,561915,355077,1458
402,CHHATTISGARH,Jashpur,851669,424747,426922,495415,280656,214759,267647,226866,197558,7553,55383,629509,15336,189588,474,467,694,14835,120768,137681,127299,64188,50562,26161,3166,529825,328438,858263,488965,214455,148100,149
403,CHHATTISGARH,Raigarh,1493984,750278,743706,951639,542756,408883,255136,208313,323788,9959,148107,1422986,17332,47653,2117,781,409,1782,246480,260661,210964,130700,93340,66358,8804,1017307,460166,1477473,841958,398257,253488,281
404,CHHATTISGARH,Korba,1206640,612915,593725,748759,433391,315368,247236,113071,221806,7899,178410,1133176,30195,21059,3666,897,753,15649,178191,188303,168387,89167,83166,61215,11792,780221,410186,1190407,729708,309479,166959,494
405,CHHATTISGARH,Janjgir - Champa,1619707,815717,803990,1019634,593679,425955,94010,281266,402359,15828,147013,1597089,14173,2926,635,556,707,2220,257020,241692,241761,152183,127543,58712,7630,1086541,587734,1674275,975114,383172,260898,523
406,CHHATTISGARH,Bilaspur,2663629,1351574,1312055,1596560,932474,664086,250297,276691,572292,21658,332556,2540763,57973,20745,6373,2979,2357,29122,382091,407692,337793,189296,152838,134637,19654,1624001,943112,2567113,1625484,655032,380114,2999
407,CHHATTISGARH,Kabeerdham,822526,412058,410468,414167,248503,165664,84446,167662,185850,3046,47598,776013,12206,980,924,433,1167,30222,126806,123840,84147,37650,28074,16671,1679,418867,376852,795719,515971,198517,107854,184
408,CHHATTISGARH,Rajnandgaon,1537133,762855,774278,1008379,561355,447024,207162,342116,290108,10847,157021,1399658,23648,5193,3761,28541,8187,67444,263447,287436,267653,105149,82141,51698,5340,1062864,467554,1530418,898915,404418,233068,732
409,CHHATTISGARH,Durg,3343872,1682101,1661771,2303378,1284612,1018766,201408,392341,560415,22565,521484,3129745,83499,24304,24276,19587,17209,42569,463598,573291,497668,309508,286244,202424,30555,2363288,823501,3186789,1919832,898241,523656,2143
410,CHHATTISGARH,Raipur,4063872,2048186,2015686,2629749,1493158,1136591,241175,383279,708993,34078,631314,3881485,103038,23181,16707,8397,17137,10680,618508,664470,552373,313247,267265,227382,31483,2674728,1247434,3922162,2454299,1038155,560184,11234
411,CHHATTISGARH,Mahasamund,1032754,511967,520787,637963,364089,273874,142557,139199,278073,6135,75853,1008061,12570,5284,2941,521,1495,1417,179770,194739,152183,78583,57949,33357,5951,702532,384764,1087296,582544,272009,177826,375
412,CHHATTISGARH,Dhamtari,799781,397897,401884,546833,303924,242909,105575,135435,182602,7310,77548,777188,10425,2644,1196,667,3612,3685,143128,148544,120146,65196,58875,31319,5096,572304,214637,786941,461125,213021,125429,206
413,CHHATTISGARH,Uttar Bastar Kanker,748941,373338,375603,456042,258298,197744,210836,194018,129142,7811,58388,627460,6040,4007,552,2213,1071,105869,135206,124893,100674,47002,43956,21410,1658,474799,243039,717838,437598,197603,113450,290
414,CHHATTISGARH,Bastar,1413199,698487,714712,650863,382335,268528,474939,284472,287828,10821,143410,1277975,12413,27951,2099,985,3466,86925,183667,178766,139330,60936,57413,32895,3227,656234,729550,1385784,864272,358157,189569,1201
415,CHHATTISGARH,Narayanpur,139820,70104,69716,56621,33449,23172,54643,44389,13820,939,11941,129161,776,600,96,71,409,8542,16980,16034,9513,4158,4488,2216,268,53657,78331,131988,91338,33956,14367,159
416,CHHATTISGARH,Dakshin Bastar Dantewada,533638,264142,269496,191237,116529,74708,210524,165389,69385,2310,49511,513915,6437,4888,457,352,1044,6071,40079,39023,27720,16665,16905,11197,1372,152961,336963,489924,334987,140188,58170,293
417,CHHATTISGARH,Bijapur,255230,128663,126567,86919,54076,32843,102670,66504,49859,1399,16763,245151,1617,2709,68,1649,15,3793,25597,22787,14170,7192,6755,3421,147,80069,163278,243347,167348,63802,23927,153
418,MADHYA PRADESH,Sheopur,687861,361784,326077,328025,208201,119824,78811,106745,115261,4166,51283,638702,41396,230,6387,201,379,40,90911,70840,43009,37072,24732,17091,1497,285152,393141,678293,449974,155063,82416,408
419,MADHYA PRADESH,Morena,1965970,1068417,897553,1179685,747652,432033,8083,304674,148222,16354,206743,1875495,76159,1092,557,3234,6681,92,288979,285682,228234,170254,115790,71005,8265,1168209,706917,1875126,1254302,452484,257704,1480
420,MADHYA PRADESH,Bhind,1703005,926843,776162,1094917,676513,418404,2848,231185,158266,9838,121479,1595400,66776,973,4047,12215,19950,73,202629,261162,199044,140743,96011,50222,8059,957870,388473,1346343,1040736,399676,258588,4005
421,MADHYA PRADESH,Gwalior,2032036,1090327,941709,1357210,803114,554096,34429,130586,120348,22592,411785,1835299,141735,4119,24790,4361,18058,217,235648,235924,204871,193082,166719,193947,23148,1253339,554486,1807825,1218319,519728,291451,2538
422,MADHYA PRADESH,Datia,786754,420157,366597,491445,303815,187630,7191,152903,93744,6839,67674,747693,28483,683,490,7923,453,10,132176,131372,88949,73398,48978,34853,4262,513988,260076,774064,473097,195131,118186,340
423,MADHYA PRADESH,Shivpuri,1726050,919795,806255,900846,573242,327604,110691,383340,220440,13079,142422,1648749,51200,1117,7151,3421,12171,72,261087,214162,125117,84684,58509,44812,6218,794589,719547,1514136,1106084,389652,227989,2325
424,MADHYA PRADESH,Tikamgarh,1445166,760355,684811,747940,459353,288587,32934,305859,223852,15622,109985,1383475,44143,588,251,109,15569,39,202448,188694,143231,78053,58245,35034,5340,711045,659348,1370393,898323,343824,201875,1144
425,MADHYA PRADESH,Chhatarpur,1762375,936121,826254,943033,572010,371023,35516,302228,238364,26390,184815,1676918,70351,1980,968,250,10409,102,270951,236054,160310,112961,77787,59704,7837,925604,770268,1695872,1112636,394060,252417,3262
426,MADHYA PRADESH,Panna,1016520,533480,483040,552559,332140,220419,83182,135445,198847,12201,85505,974748,35214,418,186,37,4734,218,171707,134936,99251,70359,47903,29795,3052,557003,427997,985000,635347,235035,144827,1311
427,MADHYA PRADESH,Sagar,2378458,1256257,1122201,1545719,908607,637112,107165,203600,378560,140458,283417,2198297,103480,5580,4146,991,62992,168,347752,426916,297079,214137,137899,116753,14346,1554882,711804,2266686,1470688,569166,335432,3172
428,MADHYA PRADESH,Damoh,1264219,661873,602346,747715,445737,301978,81486,114611,250165,67383,142436,1186420,47966,1681,1096,119,25005,82,197917,217296,150040,95032,64414,41158,5260,771117,469038,1240155,768929,312593,181403,1294
429,MADHYA PRADESH,Satna,2228935,1157495,1071440,1371781,801051,570730,156809,227967,371584,46056,265742,2158623,59471,2228,1163,364,3135,1689,338947,334635,309536,197373,148091,105499,16052,1450133,715509,2165642,1365647,535086,326049,2153
430,MADHYA PRADESH,Rewa,2365106,1225100,1140006,1441757,845572,596185,150289,258321,463506,50878,219241,2268838,85414,1964,832,986,655,232,344362,330131,312931,206274,180635,122371,11438,1508142,766166,2274308,1460075,540235,362228,2568
431,MADHYA PRADESH,Umaria,644758,330674,314084,356672,210907,145765,148699,65369,145690,8767,69865,620515,15966,667,190,70,220,6028,90791,94011,74854,43418,27216,18144,2784,351218,230782,582000,403030,158140,82984,604
432,MADHYA PRADESH,Neemuch,826067,422653,403414,508834,307889,200945,34703,175602,136330,4020,102730,741288,67324,1508,1110,224,14165,115,137656,127167,83189,69134,53465,42343,6119,519073,289113,808186,476995,217403,131227,442
433,MADHYA PRADESH,Mandsaur,1340411,682851,657560,834591,502898,331693,16069,281465,266350,8556,123352,1192588,125548,1120,849,242,19029,77,244891,217234,149219,109751,77219,52546,4956,855816,467002,1322818,781000,346861,211815,735
434,MADHYA PRADESH,Ratlam,1455069,738241,716828,825880,485090,340790,203575,218692,305946,11928,154414,1267043,151071,3996,1353,175,29353,123,224715,194131,129392,111461,86507,67192,5868,819266,622153,1441419,876905,363858,213560,746
435,MADHYA PRADESH,Ujjain,1986864,1016289,970575,1240990,730817,510173,23805,289013,302003,19678,286748,1718204,233133,4659,3241,945,24622,211,286534,280030,178295,159263,119586,111290,13282,1148280,659279,1807559,1156749,508302,320502,1311
436,MADHYA PRADESH,Shajapur,1512681,780520,732161,894612,543509,351103,18420,287924,303157,8809,117981,1321003,174724,815,631,179,13755,66,271215,239081,141225,111366,75967,48671,3391,890916,544791,1435707,901161,369741,240768,1011
437,MADHYA PRADESH,Dewas,1563715,805359,758356,925369,550716,374653,133527,260222,310606,11816,160032,1376591,174259,2355,2330,382,6497,72,242508,225380,149522,125772,94403,55383,4991,897959,565365,1463324,943954,388648,230280,833
438,MADHYA PRADESH,Dhar,2185793,1112725,1073068,1077338,638479,438859,608195,385522,437437,15830,189185,2051219,116202,2261,1607,328,12199,88,262090,244058,164576,134279,99882,66721,6543,978149,1021851,2000000,1377326,533243,273050,2174
439,MADHYA PRADESH,Indore,3276697,1699627,1577070,2309130,1289631,1019499,104992,150907,185528,43584,888176,2728225,415142,18523,25696,11496,71667,720,428413,472233,384611,362209,300076,382658,36326,2366526,718174,3084700,1877270,894464,493096,11867
440,MADHYA PRADESH,Khargone (West Nimar),1873046,953121,919925,986234,575428,410806,363342,307085,425712,11524,149798,1725441,135085,2075,2896,284,6028,89,287410,256930,152267,114246,89581,64150,5291,969875,932619,1902494,1166866,450248,254570,1362
441,MADHYA PRADESH,Barwani,1385881,699340,686541,549926,313642,236284,479963,287704,267196,7451,91546,1318869,58222,2967,2361,416,2289,263,157337,137116,74067,59100,42649,30754,2581,503604,825034,1328638,923665,302833,158594,789
442,MADHYA PRADESH,Rajgarh,1545814,790212,755602,804245,488797,315448,26274,285095,330820,12123,117565,1433879,106928,1243,460,121,1599,50,239738,174381,103464,96386,72316,51499,4799,742583,706958,1449541,935230,363218,246447,919
443,MADHYA PRADESH,Vidisha,1458875,769568,689307,862918,512344,350574,32610,168615,228308,12408,141071,1287391,149548,1313,914,295,18490,70,242021,214603,123650,104007,65581,59814,6780,816456,512311,1328767,919239,335690,203005,941
444,MADHYA PRADESH,Bhopal,2371061,1236130,1134931,1660690,920314,740376,33463,73346,105195,24732,664184,1755861,525434,23432,10789,21688,25950,335,229082,303171,287198,211371,178165,266618,30845,1506450,462581,1969031,1405814,625594,330291,9362
445,MADHYA PRADESH,Sehore,1311332,683743,627589,780362,469208,311154,71121,201307,227026,9917,147837,1163607,137980,1404,640,357,6232,66,193885,179388,136284,120687,77541,50655,6755,765195,508396,1273591,817608,305605,187611,508
446,MADHYA PRADESH,Raisen,1331597,700358,631239,820220,479093,341127,99379,138725,228151,17316,133646,1195235,120331,1725,2262,253,10637,190,237981,210402,144108,117908,69419,48384,4607,832809,444877,1277686,832939,316319,181524,815
447,MADHYA PRADESH,Betul,1575362,799236,776126,939769,529783,409986,333852,253602,358157,11849,163372,1505745,37590,3271,1078,9651,3759,13048,239114,232532,176325,140402,105696,82761,5876,982706,603098,1585804,938819,392728,242592,1223
448,MADHYA PRADESH,Harda,570465,294838,275627,352550,203807,148743,78232,68019,101256,6459,55245,527462,38640,683,676,93,1573,55,90059,87733,60757,46556,31939,27126,3469,347639,177731,525370,347774,138882,83417,392
449,MADHYA PRADESH,Hoshangabad,1241350,648725,592625,810644,469199,341445,96259,116440,181967,9982,169693,1175203,52269,4453,3127,1550,3888,107,159703,183156,145076,119682,89589,84769,9279,791254,344492,1135746,730768,318232,191501,849
450,MADHYA PRADESH,Katni,1292042,662013,630029,790773,460583,330190,157900,112812,223902,31261,175899,1240650,37232,3158,1167,157,5342,2643,198447,207366,161727,112242,80935,53578,6658,820953,465374,1286327,778414,326582,185857,1189
451,MADHYA PRADESH,Jabalpur,2463289,1277278,1186011,1756468,980307,776161,185316,106882,283636,69946,545160,2159065,203652,23142,13256,4320,33728,21010,267932,352284,313910,268333,222987,235072,24872,1685390,540029,2225419,1387369,679185,391903,4832
452,MADHYA PRADESH,Narsimhapur,1091854,568810,523044,718785,413491,305294,71752,113866,257865,10594,95493,1038628,39048,914,997,262,8125,2873,160765,180070,128758,109996,82020,52763,5802,720174,356987,1077161,620415,289560,180831,1048
453,MADHYA PRADESH,Dindori,704524,351913,352611,378714,222759,155955,230090,150084,190962,7958,40921,605435,6736,4238,260,61,687,84006,103002,113875,84065,49277,31104,15179,1674,398176,295655,693831,419531,181841,102522,630
454,MADHYA PRADESH,Mandla,1054905,525272,529633,604962,348033,256929,310610,148931,318909,9453,82356,849518,16558,12450,436,297,1789,170533,156711,170994,115632,82166,58066,35476,4587,623632,376944,1000576,614794,278553,160510,1048
455,MADHYA PRADESH,Chhindwara,2090922,1064468,1026454,1294198,731294,562904,383993,283111,422668,14585,237620,1923920,100692,4893,2258,24471,7830,25771,284113,336391,225747,215098,167946,112383,12141,1353819,663446,2017265,1232263,535316,321977,1366
456,MADHYA PRADESH,Seoni,1379131,695879,683252,864194,485341,378853,261735,173665,376404,11957,122408,1145052,79739,1857,360,7288,4982,135315,223650,241327,151636,116124,84398,55984,6427,879546,458811,1338357,809922,363037,205237,935
457,MADHYA PRADESH,Balaghat,1701698,842178,859520,1147623,626468,521155,196047,257785,459796,19245,156188,1519384,38542,5295,1050,72162,4778,58064,290699,312640,235251,168635,126308,74213,7414,1215160,493415,1708575,969773,453605,276799,1521
458,MADHYA PRADESH,Guna,1241519,649362,592157,653980,400537,253443,92613,213949,175615,12079,113254,1172248,49203,1208,3271,529,13474,52,197902,157141,84560,79924,50724,42147,6451,618849,578034,1196883,793150,285176,162104,1089
459,MADHYA PRADESH,Ashoknagar,845071,443837,401234,469109,290304,178805,39625,116913,122387,10559,65411,778214,40707,635,8009,1352,15094,27,148647,117053,62802,51499,29551,22791,3466,435809,359525,795334,535410,194772,114131,758
460,MADHYA PRADESH,Shahdol,1066063,540021,526042,604194,348761,255433,239061,95795,258991,14329,123942,997073,42426,2372,912,268,1737,19448,161972,154282,128427,80402,60915,46513,5352,637863,422736,1060599,645619,269145,150655,644
461,MADHYA PRADESH,Anuppur,749237,379114,370123,436595,254120,182475,180566,115448,130376,7051,93596,686524,21473,2132,606,86,1653,35434,113208,115716,93450,58536,42743,31646,3066,458365,271733,730098,444954,193520,109813,950
462,MADHYA PRADESH,Sidhi,1127033,575912,551121,600785,353030,247755,154112,102644,262030,15654,81432,1077545,34419,511,128,92,93,12556,185550,168224,129344,80312,60845,33067,3896,661238,477472,1138710,721531,253685,150959,858
463,MADHYA PRADESH,Singrauli,1178273,613637,564636,585054,359923,225131,187861,147732,228472,8856,114379,1118998,46574,2332,1422,338,182,6139,189929,150446,103971,61089,42434,30597,7449,585915,517447,1103362,771725,267189,138276,1083
464,MADHYA PRADESH,Jhabua,1025048,515023,510025,352081,214582,137499,445459,329175,115649,5132,65165,960925,15733,38423,141,65,8871,388,98308,79781,40466,38236,28990,20240,1973,307994,775664,1083658,684200,220769,119681,398
465,MADHYA PRADESH,Alirajpur,728999,362542,366457,209754,120905,88849,326796,256393,73693,4066,32645,705060,17660,4600,65,36,780,271,43866,44457,22410,18213,15358,10040,1028,155372,658684,814056,488848,155328,84149,674
466,MADHYA PRADESH,Khandwa (East Nimar),1310061,674329,635732,731615,432259,299356,224255,179337,306623,9852,117164,1182330,116277,2800,1726,1425,3856,158,203486,201537,115166,77010,56847,42771,4970,701787,551824,1253611,809091,313456,186928,586
467,MADHYA PRADESH,Burhanpur,757847,388504,369343,408679,233073,175606,113675,67799,156295,8077,96168,552526,180840,1199,1074,19883,1884,99,107547,119468,69765,57058,42618,28237,4761,429454,317962,747416,469838,181605,106034,370
468,GUJARAT,Kachchh,2092371,1096737,995634,1252319,739239,513080,11403,105876,183971,10802,475579,1608921,442355,6192,6353,490,25312,98,246956,469402,141345,157284,61366,60386,14062,1150801,581952,1732753,1278604,524052,286086,3629
469,GUJARAT,Banas Kantha,3120506,1610379,1510127,1704923,1048402,656521,139800,475585,350541,11812,410662,2890305,213505,1686,486,281,12659,83,366867,859436,159433,226765,105372,66950,14451,1799274,1207376,3006650,1984701,738412,394793,2600
470,GUJARAT,Patan,1343734,694397,649337,837913,494631,343282,6468,136590,227080,6392,184768,1194745,142797,916,337,66,3602,66,168990,364667,78731,129584,57494,46355,11111,856932,452891,1309823,786357,341381,213465,2531
471,GUJARAT,Mahesana,2035064,1056520,978544,1502645,847499,655146,4513,189760,242969,10282,369053,1885732,136431,1954,1082,146,7087,88,260278,467128,183468,266108,139208,130723,27391,1474304,434497,1908801,1119451,554432,357578,3603
472,GUJARAT,Sabar Kantha,2428589,1244231,1184358,1578734,918625,660109,269625,366711,333867,10909,373391,2260560,148563,6375,614,168,11110,52,214062,597667,211423,333650,198963,110817,24745,1691327,665058,2356385,1393131,630963,400905,3590
473,GUJARAT,Gandhinagar,1391753,723864,667889,1030494,582686,447808,8493,104147,129356,8600,292873,1319586,57273,3237,1985,497,6405,82,136131,363156,133594,196456,95730,108400,16088,1049555,246993,1296548,769329,391862,224886,5676
474,GUJARAT,Ahmadabad,7214225,3788051,3426174,5435760,3025463,2410297,42032,142670,268954,54876,2128452,6042416,883238,50754,14542,4518,209287,2055,761358,1614370,805199,1135058,549188,839295,100831,5805299,1129562,6934861,3952858,2043895,1198152,19320
475,GUJARAT,Surendranagar,1756268,909917,846351,1093626,643221,450405,10385,185235,270861,9518,257886,1620282,109681,1419,512,312,22992,128,234873,482679,165406,172947,61164,58389,14501,1189959,493427,1683386,1033435,439352,280582,2899
476,GUJARAT,Rajkot,3804558,1974445,1830113,2725056,1514075,1210981,11513,349357,214285,23780,891628,3397406,361388,5478,1918,1170,33591,269,383780,913928,402240,540278,204306,266295,29924,2740751,738660,3479411,2080568,1052871,659576,11543
477,GUJARAT,Jamnagar,2160119,1114192,1045927,1396534,795140,601394,11772,264318,147193,11359,424570,1810443,320805,4392,1873,1086,18856,136,255785,491009,194057,199634,74029,87523,18573,1320610,502873,1823483,1220598,576319,358455,4747
478,GUJARAT,Porbandar,585449,300209,285240,393678,221621,172057,6309,65702,48964,2371,114132,549749,33565,500,248,91,515,38,50588,150643,71637,63458,25119,22458,5260,389163,137119,526282,314886,163777,105638,1148
479,GUJARAT,Junagadh,2743082,1404356,1338726,1842818,1046981,795837,27108,367311,333996,9645,412757,2397056,334858,2586,1110,1291,3841,77,271762,700258,294811,311849,137505,139957,30127,1886269,669022,2555291,1527888,749156,461650,4388
480,GUJARAT,Amreli,1514190,771049,743141,995459,558180,437279,3466,232126,209935,6083,208995,1410463,99105,919,415,243,2053,40,230474,412251,120625,149478,66785,50999,8582,1039194,380595,1419789,836343,389892,282409,5546
481,GUJARAT,Bhavnagar,2880365,1490201,1390164,1887255,1087371,799884,4359,231796,334025,17996,566815,2632574,212863,3457,1410,445,26974,127,422461,929286,266953,281250,96241,93391,13946,2103528,508664,2612192,1708938,720241,445121,6065
482,GUJARAT,Anand,2092745,1087224,1005521,1551253,874481,676772,12063,152412,346329,16460,329593,1798794,250919,29789,1524,267,8591,142,257524,560542,229013,283571,127459,110351,20487,1588947,360506,1949453,1134962,585093,366419,6271
483,GUJARAT,Kheda,2299885,1185727,1114158,1660243,942480,717763,19279,239241,359842,12455,322445,2000884,264482,26629,1403,300,3479,82,295057,641541,250044,310341,148530,84223,19498,1749234,482078,2231312,1260660,628221,388646,22358
484,GUJARAT,Panch Mahals,2390776,1226961,1163815,1440805,858054,582751,353256,456768,376038,10771,253930,2220974,158513,2863,662,337,5236,131,255905,601358,205420,283648,139773,71810,17958,1575872,781582,2357454,1421859,599925,363391,5601
485,GUJARAT,Dohad,2127086,1068651,1058435,1007171,599035,408136,787545,388612,438597,8815,163100,2045243,66353,9907,493,260,3331,114,214098,392739,114168,156556,95794,41458,9656,1024469,1047088,2071557,1402616,467115,252153,5202
486,GUJARAT,Vadodara,4165626,2153736,2011890,2893080,1614087,1278993,563236,312126,570361,17680,793306,3713941,384579,23813,9340,2069,27650,1124,396624,865726,457662,504732,268451,314960,60177,2868332,910219,3778551,2213474,1190041,733710,28401
487,GUJARAT,Narmada,590297,301086,289211,370336,211767,158569,236868,62823,188030,2594,41348,559848,22600,4413,147,80,373,2078,76197,146661,58188,52687,28396,14748,3451,380328,192780,573108,336830,157910,93466,2091
488,GUJARAT,Bharuch,1551019,805707,745312,1118276,623047,495229,237796,78120,253577,8902,286525,1188204,343511,9494,1733,442,4813,342,161675,367060,164765,188539,83895,74380,16036,1056350,273829,1330179,844298,442523,254728,9470
489,GUJARAT,The Dangs,228291,113821,114470,140968,77314,63654,108534,64561,40486,1172,12038,203545,3593,20029,69,32,39,560,43639,59954,17736,14872,7560,3490,2215,149466,91160,240626,146095,51821,30027,348
490,GUJARAT,Navsari,1329672,678165,651507,1001909,539471,462438,319919,112809,206608,7173,265244,1225087,78669,5733,2459,601,13386,2823,145678,266733,140235,190861,112460,85041,26012,967020,261956,1228976,673014,390349,258957,7352
491,GUJARAT,Valsad,1705678,887222,818456,1170657,655528,515129,451818,147569,183025,11833,400818,1571147,94034,19661,1589,913,13809,1417,165459,303197,171712,212318,123281,90912,26987,1093866,405928,1499794,944532,485874,259906,15366
492,GUJARAT,Surat,6081322,3402224,2679098,4571410,2687468,1883942,424863,109549,325739,42040,2076214,5260193,660772,21052,5703,12902,112835,3920,566242,1332690,807021,896927,433651,379505,79862,4495898,942150,5438048,3563443,1740746,723415,53718
493,GUJARAT,Tapi,807022,402188,404834,490036,269007,221029,343362,105726,254786,9679,80711,725890,22309,52930,239,1476,1828,408,84559,174139,75545,86580,49482,31743,8767,510815,292102,802917,422047,235019,144575,5381
494,DAMAN AND DIU,Diu,52074,25642,26432,38058,20327,17731,54,471,291,275,14713,48613,3190,202,3,1,43,0,1872,7668,8545,9051,4367,1906,635,34044,10735,44779,30475,13932,7599,68
495,DAMAN AND DIU,Daman,191173,124659,66514,150348,104316,46032,7538,1845,481,409,102786,171537,16087,2618,169,216,244,79,8957,28094,30406,26991,14170,9128,1995,119741,20641,140382,122589,52868,15428,288
496,DADRA AND NAGAR HAVELI,Dadra AND Nagar Haveli,343709,193760,149949,223230,142521,80709,89720,28164,17799,2195,109003,322857,12922,5113,217,634,1186,293,24701,69140,32004,37809,22700,19655,3566,209575,91055,300630,225103,87888,30346,372
497,MAHARASHTRA,Nandurbar,1648295,833170,815125,906509,512099,394410,573907,211672,438176,14599,127618,1521618,96182,8467,685,4969,6191,2907,166664,218718,121404,160961,113019,58461,9248,848475,790613,1639088,1011352,390419,241534,4990
498,MAHARASHTRA,Dhule,2050862,1054031,996831,1293916,723388,570528,320281,239139,429536,20646,247049,1825460,187901,3653,1422,13405,12818,912,200494,323641,208571,290656,182739,114931,14526,1335558,649568,1985126,1167569,513908,350747,18638
499,MAHARASHTRA,Jalgaon,4229917,2197365,2032552,2891882,1629223,1262659,294217,384359,937174,38930,503108,3457615,560261,7091,3091,143865,27404,9662,482462,735730,532587,627198,375643,229987,31008,3014615,1003050,4017665,2352671,1080237,763529,33480
500,MAHARASHTRA,Buldana,2586258,1337560,1248698,1879874,1048892,830982,60684,385447,603227,13770,217197,1845424,354236,3531,1668,364229,12242,522,315408,457067,400342,406379,228266,113783,19619,1940864,600436,2541300,1467457,641840,473071,3890
501,MAHARASHTRA,Akola,1813906,932334,881572,1411281,758977,652304,48921,129680,388521,9660,240293,1107809,357253,4483,1504,328033,10205,389,231841,328367,275264,291391,205723,112574,15157,1460317,352687,1813004,998769,483200,327932,4005
502,MAHARASHTRA,Washim,1197160,620302,576858,869917,487703,382214,39068,165598,310195,7122,86877,859949,142672,1707,518,179330,8476,381,166509,238985,160331,162762,116032,47865,7294,899778,291525,1191303,682919,302425,210185,1631
503,MAHARASHTRA,Amravati,2888445,1480768,1407677,2251875,1207104,1044771,198294,198793,667943,20998,348588,2055177,421410,7223,2242,383891,11360,3288,326195,468853,463051,525116,346876,203273,16148,2349512,478074,2827586,1540590,783549,553265,11041
504,MAHARASHTRA,Wardha,1300774,668385,632389,1019458,552617,466841,72809,132989,282170,13785,179291,1057096,53854,2696,2147,175417,5663,2254,140470,186781,201471,225208,158055,93772,7017,1012774,212054,1224828,659540,370227,270107,900
505,MAHARASHTRA,Nagpur,4653570,2384975,2268595,3673808,1959220,1714588,214005,206606,423587,52419,1185948,3492202,390974,34667,20469,668050,24528,12181,325084,666693,812381,790443,542228,493236,73475,3703540,601547,4305087,2460820,1361821,818467,12462
506,MAHARASHTRA,Bhandara,1200334,605520,594814,899860,488709,411151,44371,123099,312183,17169,144854,1009352,26502,2145,831,154458,1017,3555,115150,187870,208902,204435,153749,67061,12452,949619,235524,1185143,626978,333120,232754,7482
507,MAHARASHTRA,Gondiya,1322507,661554,660953,1004243,542837,461406,108309,186509,281414,32525,164971,1153861,26157,1827,2160,125282,1568,5080,138457,237888,231153,225595,159570,57923,9620,1060206,256549,1316755,704214,371908,244111,2274
508,MAHARASHTRA,Gadchiroli,1072942,541328,531614,708365,395110,313255,207929,225358,247813,11321,99745,927411,21063,3872,681,82695,454,30047,108850,145767,139482,140345,95911,35809,4154,670318,360229,1030547,605217,289448,175518,2759
509,MAHARASHTRA,Chandrapur,2204307,1123834,1080473,1578615,872565,706050,192688,220978,473983,21346,341865,1780085,92297,10701,5251,286734,3861,23188,243773,316192,337320,351610,241179,126488,15040,1631602,516728,2148330,1163802,629890,403719,6896
510,MAHARASHTRA,Yavatmal,2772348,1419965,1352383,2022574,1115980,906594,253161,333504,739718,17899,264878,2251401,239236,4567,1596,249874,11422,3745,391944,562739,382001,389924,245819,123074,21889,2117390,718204,2835594,1549263,733258,483813,6014
511,MAHARASHTRA,Nanded,3361292,1730075,1631217,2189425,1255222,934203,137803,447823,632395,29158,384577,2501741,471951,3902,13540,354189,5049,1273,416869,691348,368723,416761,255650,156225,21729,2327305,884626,3211931,2008314,809135,535827,8016
512,MAHARASHTRA,Hingoli,1177345,606294,571051,790743,450551,340192,54280,241613,226483,8268,92818,863199,127552,992,643,176679,5278,103,175736,266649,127246,136075,74544,38698,5932,824880,331388,1156268,692117,281905,201828,1495
513,MAHARASHTRA,Parbhani,1836086,942870,893216,1157814,666291,491523,19944,295030,317806,13210,196751,1328385,306364,2081,1371,187899,6238,262,229217,396713,204316,229103,116041,81333,9703,1266426,552643,1819069,1078349,436486,313455,7796
514,MAHARASHTRA,Jalna,1959046,1011473,947573,1195523,699428,496095,20275,418952,300937,16705,194292,1504641,274221,12542,1629,152540,9619,336,271061,422207,218189,225331,120715,64060,9724,1331287,545980,1877267,1150104,454836,341479,12627
515,MAHARASHTRA,Aurangabad,3701282,1924469,1776813,2503837,1430936,1072901,69490,554518,396630,28033,595898,2545438,786677,15991,5142,309093,30981,1005,381695,686271,422964,537936,310762,253253,19101,2611982,819734,3431716,2211996,909771,571932,7583
516,MAHARASHTRA,Nashik,6107187,3157186,2950001,4345366,2397538,1947828,771822,967385,730228,56132,1009583,5237009,693052,23946,8912,94783,38212,1795,544346,1038955,851714,830070,485052,373100,97219,4220456,1481778,5702234,3580633,1567252,948469,10833
517,MAHARASHTRA,Thane,11060148,5865078,5195070,8227161,4591396,3635765,773259,349931,418004,124461,3600371,8716055,1355630,280700,39149,449617,172052,9862,712171,1530916,1588196,1751284,1080597,961719,114453,7739336,1692022,9431358,6184519,3241888,1579921,53820
518,MAHARASHTRA,Mumbai Suburban,9356962,5031323,4325639,7575485,4223029,3352456,49527,16086,20722,118816,3579397,6337132,1795788,322476,47288,469568,343639,18345,512268,1140066,1628031,1914168,1091433,1183117,189063,7658146,1111093,8769239,4936360,2812001,1575566,33035
519,MAHARASHTRA,Mumbai,3085411,1684608,1400803,2509022,1410680,1098342,11605,6051,5745,45538,1227062,1873762,773173,84555,13471,134257,166000,31094,118967,399792,603937,665263,378764,343374,57044,2567141,262312,2829453,1553005,933586,583243,15577
520,MAHARASHTRA,Raigarh,2634200,1344345,1289855,1939994,1059692,880302,151468,206975,191182,32919,641893,2239370,227465,17452,7477,121791,12260,1159,231263,407662,335886,441072,221410,204507,19940,1861740,482420,2344160,1414154,748339,462741,8966
521,MAHARASHTRA,Pune,9429408,4924105,4505303,7171723,3940210,3231513,169744,886530,414461,105711,2642291,8090254,673704,134192,27090,340404,127786,9873,559840,1234549,1383055,1414563,867256,1086650,190336,6736249,1353077,8089326,5184734,2624165,1586132,34377
522,MAHARASHTRA,Ahmadnagar,4543159,2342825,2200334,3151890,1773355,1378535,187065,1013050,559009,57156,575375,4107143,320743,22766,5431,33898,38718,1408,483996,833691,580959,745895,411908,315842,32304,3404595,1061271,4465866,2496560,1166245,865139,15215
523,MAHARASHTRA,Bid,2585049,1349106,1235943,1718507,987185,731322,15916,606280,373566,21093,254609,2174672,320395,2097,824,68482,8719,399,309704,436446,280800,316758,206530,129996,11438,1691672,821607,2513279,1473882,614615,494436,2116
524,MAHARASHTRA,Latur,2454196,1273140,1181056,1650672,932432,718240,27616,331780,416578,17663,280836,2006984,367664,2387,935,66535,6387,310,268627,423711,296910,380344,224998,153256,18106,1765952,596213,2362165,1406364,584243,453229,10360
525,MAHARASHTRA,Osmanabad,1657576,861535,796041,1137810,644304,493506,17470,297361,299525,19831,157199,1437623,178925,942,340,28216,4530,195,183972,300965,201646,260772,139479,96847,9913,1193594,440363,1633957,917343,393539,343021,3673
526,MAHARASHTRA,Solapur,4317756,2227852,2089904,2910676,1651266,1259410,37807,637250,558334,71106,631705,3795424,441254,9882,1279,35497,28134,568,390337,788150,535848,643327,328020,236302,29051,2951035,976795,3927830,2402794,1089900,809935,15127
527,MAHARASHTRA,Satara,3003741,1510842,1492899,2225694,1201034,1024660,14425,585876,297241,39772,432058,2691952,146970,4408,1182,141315,12810,676,288427,495822,407977,556706,299993,243457,20884,2313266,545423,2858689,1517324,800492,671702,14223
528,MAHARASHTRA,Ratnagiri,1615069,761121,853948,1199392,619012,580380,9972,296913,153117,17230,246816,1307211,187197,1990,230,113467,3347,95,163025,378554,269872,247257,111600,65700,15429,1251437,319622,1571059,777431,438905,396967,1766
529,MAHARASHTRA,Sindhudurg,849651,417332,432319,666067,348289,317778,3401,124812,81816,9679,130871,780384,26264,15471,219,24762,1046,53,86480,165284,134734,175070,89023,48418,3451,702460,121922,824382,382024,242296,222963,2368
530,MAHARASHTRA,Kolhapur,3876001,1980658,1895343,2825845,1559760,1266085,14728,660872,266028,59932,717222,3379906,286558,15573,1570,29766,154882,1274,321457,622362,487227,698604,395234,335413,40828,2901125,778000,3679125,1972486,1084858,801590,17067
531,MAHARASHTRA,Sangli,2822143,1435728,1386415,2049467,1121550,927917,8927,480554,290693,40824,403033,2440312,239607,9098,1260,38210,87453,769,208511,507318,459156,453404,244804,214003,36983,2124179,579039,2703218,1450907,752303,603739,15194
532,ANDHRA PRADESH,Adilabad,2741239,1369597,1371642,1483347,856350,626997,248322,363737,484912,84661,390357,2399901,275970,15422,1377,25510,617,322,232470,344167,281752,225957,143143,100226,19277,1346992,1030640,2377632,1536378,704551,422522,77788
533,ANDHRA PRADESH,Nizamabad,2551335,1250641,1300694,1389810,790214,599596,97262,278102,448281,171311,363382,2123426,391596,19653,2357,1847,542,146,269487,421399,338668,396396,223365,141850,13382,1804547,1041862,2846409,1399773,676401,437573,37588
534,ANDHRA PRADESH,Karimnagar,3776269,1880800,1895469,2206829,1257238,949591,53250,360390,756859,168340,591179,3491139,244723,24979,2086,332,312,115,340372,453505,482842,463403,293493,256633,35312,2325560,1280393,3605953,1940234,1031735,728494,75806
535,ANDHRA PRADESH,Medak,3033288,1523030,1510258,1637137,953406,683731,82411,353221,571129,67642,450211,2637313,342449,34301,1309,554,457,217,324267,503713,481984,373729,201928,127493,16466,2029580,1199818,3229398,1735769,779738,509368,8413
536,ANDHRA PRADESH,Hyderabad,3943323,2018575,1924748,2892155,1542688,1349467,23381,28308,23029,46157,1315803,2046051,1713405,87522,11446,1268,19560,1929,230962,596591,685215,811501,517425,558090,45937,3445721,556902,4002623,2249130,1068243,542669,83281
537,ANDHRA PRADESH,Rangareddy,5296741,2701008,2595733,3538028,1948784,1589244,105989,270925,349032,73387,1502734,4458858,617518,144037,8062,2041,3536,1629,457916,756588,809283,821821,598940,740896,57436,4242880,1158473,5401353,2966988,1455864,738037,135852
538,ANDHRA PRADESH,Mahbubnagar,4053028,2050386,2002642,1940646,1158386,782260,177234,569142,931084,57846,524429,3673456,334172,21345,658,290,388,267,419379,596134,441585,308575,169083,98227,16121,2049104,1604319,3653423,2360874,1027525,637430,27199
539,ANDHRA PRADESH,Nalgonda,3488809,1759772,1729037,2001019,1160757,840262,190403,325224,863131,45124,508214,3249231,188646,35025,937,241,250,132,369537,518669,471233,367424,238695,196134,27003,2188695,1294811,3483506,1932349,897137,651748,7575
540,ANDHRA PRADESH,Warangal,3512576,1759281,1753295,2065023,1179790,885233,261680,401646,758092,43550,502367,3273755,197333,31377,1453,253,569,126,314252,457529,454322,430242,279234,248942,27663,2212184,1191252,3403436,1891954,941452,664872,14298
541,ANDHRA PRADESH,Khammam,2797370,1390988,1406382,1630234,901640,728594,387033,224972,804537,19799,360754,2595321,158887,33463,655,217,459,539,295639,346118,329630,238811,154774,160804,25456,1551232,875272,2426504,1530602,774583,477955,14230
542,ANDHRA PRADESH,Srikakulam,2703114,1341738,1361376,1495381,857824,637557,84736,165317,700833,34479,389659,2666950,9025,18879,193,77,160,106,291793,348354,319244,251521,146721,121213,21031,1499877,1009992,2509869,1423119,747385,528736,3874
543,ANDHRA PRADESH,Vizianagaram,2344474,1161477,1182997,1238388,707503,530885,120869,212285,557254,27469,360954,2299129,16423,17853,380,114,815,183,250446,300057,257468,186576,115144,103591,27041,1240323,1031683,2272006,1206366,666394,451469,20245
544,ANDHRA PRADESH,Visakhapatnam,4290589,2138910,2151679,2568249,1422878,1145371,315595,322164,578949,54545,934221,4105320,86330,77607,2301,850,2316,286,414636,568178,649271,541942,329770,289734,44164,2837695,1418851,4256546,2274553,1245627,716066,54343
545,ANDHRA PRADESH,East Godavari,5154296,2569688,2584608,3288577,1716933,1571644,108773,160407,1122046,57853,753375,4983330,77777,77825,738,413,4149,403,669420,947606,797497,521562,271809,263023,47702,3518619,1524603,5043222,2724328,1478954,948122,2892
546,ANDHRA PRADESH,West Godavari,3936966,1964918,1972048,2652389,1379223,1273166,55705,155275,1061787,33861,522189,3733191,86142,109120,288,209,1578,211,595331,718960,585595,415178,215863,207586,33329,2771842,1028767,3800609,2051513,1127764,755533,2156
547,ANDHRA PRADESH,Krishna,4517398,2267375,2250023,3009718,1598959,1410759,65730,150166,1006976,48444,843294,4023678,307043,145598,1393,863,6320,906,618101,692968,630603,531821,312753,328454,54728,3169428,1352499,4521927,2340943,1284630,833959,57866
548,ANDHRA PRADESH,Guntur,4887813,2440521,2447292,2960441,1634726,1325715,121984,302341,1227956,47436,803891,4217597,559770,89763,764,323,3282,332,736270,845810,674957,453446,246580,221924,30279,3209266,1474349,4683615,2583462,1371811,928462,4078
549,ANDHRA PRADESH,Prakasam,3397448,1714764,1682684,1904435,1107686,796749,74468,280029,889218,42603,488717,3150195,220654,18775,266,97,204,206,489805,495556,368919,249034,142026,133627,21976,1900943,1218310,3119253,1832695,917391,641707,5655
550,ANDHRA PRADESH,Sri Potti Sriramulu Nellore,2963557,1492974,1470583,1832189,1011922,820267,140829,165513,625262,35403,488383,2639737,288378,26202,678,239,2610,146,437438,451130,370710,267243,161031,148394,27865,1863811,940785,2804596,1574713,840448,544022,4374
551,ANDHRA PRADESH,Y.S.R.,2882469,1451777,1430692,1716766,994699,722067,37315,243607,542455,55824,478518,2391231,454108,23281,367,105,751,245,408650,509166,413364,258798,140145,116330,16231,1862684,893657,2756341,1553667,793583,530412,4807
552,ANDHRA PRADESH,Kurnool,4053463,2039227,2014236,2127161,1246369,880792,40779,310954,1037302,60791,620378,3328380,670737,33165,737,255,2235,434,521327,672951,466940,271828,152453,115504,19282,2220285,1517933,3738218,2368684,1053618,609027,22134
553,ANDHRA PRADESH,Anantapur,4081148,2064495,2016653,2310960,1338474,972486,75554,413253,879537,105343,638033,3599372,443456,20463,932,341,1417,309,462273,720357,582075,331793,162175,144915,23341,2426929,1369069,3795998,2189396,1104565,739612,47575
554,ANDHRA PRADESH,Chittoor,4174064,2090204,2083860,2667878,1484794,1183084,79409,434544,748093,57269,693451,3737588,397870,24129,867,253,1322,358,522961,770836,673197,548336,265199,246409,36017,3062955,1170993,4233948,2148179,1159053,807430,59402
555,KARNATAKA,Belgaum,4779661,2423063,2356598,3052032,1725548,1326484,148525,711980,649517,60342,683829,4038331,528412,18418,2037,1086,178310,149,544564,1057297,609600,532584,279583,201884,56621,3282133,1346776,4628909,2669348,1251116,857143,2054
556,KARNATAKA,Bagalkot,1889752,950111,939641,1113412,641388,472024,48733,196199,303243,44797,273842,1634229,219991,3433,443,412,25198,166,242336,385986,147397,171505,115095,82319,25791,1170429,608843,1779272,1123443,465706,299774,829
557,KARNATAKA,Bijapur,2177331,1111022,1066309,1248268,730566,517702,19402,262217,351600,25379,288526,1786830,369588,2433,558,374,8665,499,246391,430477,143199,182756,129109,96990,24569,1253491,746979,2000470,1295274,527085,353549,1423
558,KARNATAKA,Bidar,1703300,870665,832635,1042673,597198,445475,116035,141302,280091,18095,263120,1289709,335184,35438,1145,30453,680,521,188998,474921,194233,181076,105347,54900,12885,1212360,515395,1727755,1018195,397120,287271,714
559,KARNATAKA,Raichur,1928812,964511,964301,979769,577213,402556,184970,245299,383526,19095,255493,1634062,272022,10394,538,2265,4156,29,147743,385673,163709,153346,82082,50463,14622,997638,783126,1780764,1196670,465173,265810,1159
560,KARNATAKA,Koppal,1389920,699926,689994,809085,468785,340300,81510,163413,273016,18794,199543,1218024,161770,4081,296,85,2898,461,222140,357098,127605,113028,72243,43967,10431,946512,472182,1418694,855430,330393,202984,1113
561,KARNATAKA,Gadag,1064570,537147,527423,700177,397178,302999,30679,127441,200310,15485,152486,907750,143665,3432,231,79,5993,74,121615,244640,112703,105150,63816,42053,12822,702799,306138,1008937,601578,279069,183409,514
562,KARNATAKA,Dharwad,1847023,937206,909817,1301664,711776,589888,43375,164279,207642,16463,396449,1390020,386834,28747,1486,715,29037,2748,252596,383041,185530,227113,143453,137768,34302,1363803,428556,1792359,1017935,505688,322577,823
563,KARNATAKA,Uttara Kannada,1437169,726256,710913,1081906,582099,499807,17144,111581,116336,9492,371117,1187306,187974,44530,305,12804,3624,64,198632,338390,183534,210270,108521,94767,22876,1156990,277857,1434847,742281,412649,281542,697
564,KARNATAKA,Haveri,1597668,819128,778540,1085443,603793,481650,69271,203055,311263,20217,195531,1281878,297927,2406,419,68,9834,702,240925,430529,201965,158442,84357,55310,16830,1188358,383494,1571852,904453,426094,266586,535
565,KARNATAKA,Bellary,2452595,1236954,1215641,1421621,813440,608181,225955,258080,406092,22832,429876,2103633,320834,14014,1029,284,8044,54,275785,529576,219702,203139,121453,89475,29367,1468497,787762,2256259,1487013,617276,346905,1401
566,KARNATAKA,Chitradurga,1659456,840843,818613,1087392,607188,480204,149615,286245,294337,26235,249770,1520553,128751,3175,322,84,3778,128,188329,332648,196470,217567,132435,75262,22078,1164789,452975,1617764,891230,460057,306412,1757
567,KARNATAKA,Davanagere,1945497,986400,959097,1308540,720637,587903,115304,230846,295873,31438,317050,1658465,265805,5420,307,164,6417,1743,242130,446793,206686,269748,154781,123863,32375,1476376,467414,1943790,1068518,538551,336173,2255
568,KARNATAKA,Shimoga,1752753,877415,875338,1263016,674938,588078,32705,204493,246464,15087,314554,1479424,234664,26521,400,120,9234,367,191641,385978,292481,251095,132138,111753,18036,1383122,355222,1738344,913150,513297,325542,764
569,KARNATAKA,Udupi,1177361,562131,615230,926429,465704,460725,26669,63143,63390,10580,376128,1009179,96740,65838,232,161,4534,155,142493,286193,176260,178094,109663,107279,18444,1018426,204028,1222454,559565,340903,276234,659
570,KARNATAKA,Chikmagalur,1137961,566622,571339,818345,438257,380088,22980,155392,126600,8873,274909,1004553,101235,26000,182,109,4710,4,114570,257550,160083,177585,96470,72420,12631,891309,204371,1095680,564994,341380,230864,723
571,KARNATAKA,Tumkur,2678980,1350594,1328386,1813391,1006024,807367,104294,505910,352286,54523,441927,2413812,245923,9130,477,187,5067,161,270373,500593,386998,423738,213588,143735,30687,1969712,686274,2655986,1351461,760936,564196,2387
572,KARNATAKA,Bangalore,9621551,5022661,4598890,7512276,4078041,3434235,91075,95619,97914,108898,3944496,7725070,1248294,504863,13254,5531,83090,498,599794,1509693,1629870,2018079,1196965,1733274,198399,8886074,1304048,10190122,5275666,2909575,1424195,12115
573,KARNATAKA,Mandya,1805769,905085,900684,1149649,638668,510981,11092,388981,216159,17834,248434,1712695,77801,8506,322,299,3607,109,145178,309476,226552,308624,157839,102838,19987,1270494,504734,1775228,902307,527236,375100,1126
574,KARNATAKA,Hassan,1776421,883667,892754,1225256,668836,556420,16343,437034,165910,16126,284510,1630814,120011,15611,289,623,5820,3,182255,354480,232531,292369,147837,103152,27774,1340398,401227,1741625,877340,522039,375918,1124
575,KARNATAKA,Dakshina Kannada,2089649,1034714,1054935,1666323,864019,802304,41307,33810,29274,188207,746430,1403854,501896,171398,525,445,10397,138,191317,520715,296110,309141,178989,185916,36295,1718483,298846,2017329,1072417,608450,407902,880
576,KARNATAKA,Kodagu,554519,274608,279911,412877,215302,197575,29544,21174,15153,1549,241062,448986,87274,17130,139,126,250,220,51287,111562,75291,86232,54939,43225,8251,430787,91352,522139,276918,163360,113919,322
577,KARNATAKA,Mysore,3001127,1511600,1489527,1962180,1063766,898414,167850,349337,311002,28162,625767,2631985,290549,39361,1255,16194,14419,493,207091,537686,404565,452412,222230,212541,26834,2063359,747237,2810596,1580116,865220,553705,2086
578,KARNATAKA,Chamarajanagar,1020791,512231,508560,565279,312957,252322,60850,113105,214303,14007,140278,942071,47210,22183,136,4872,761,140,82487,204765,132421,109361,57053,34799,9600,630486,401643,1032129,519046,294903,206003,839
579,KARNATAKA,Gulbarga,2566326,1301755,1264571,1427368,828359,599009,32429,220198,415267,25891,425672,2011014,513125,8344,826,9589,4865,330,177860,579057,270622,290570,153746,104256,20492,1596603,883704,2480307,1570719,604665,388935,2007
580,KARNATAKA,Yadgir,1174271,590329,583942,510003,306751,203252,73285,159333,234655,13192,140516,997974,155340,8677,331,7970,1519,996,98481,204926,77942,73599,40104,27728,4634,527414,579042,1106456,738451,267222,168186,412
581,KARNATAKA,Kolar,1536401,776396,760005,1016219,564110,452109,38878,183057,201233,24178,309404,1305431,199873,26722,253,150,2494,92,138015,289841,228422,225498,107929,71422,17961,1079088,399089,1478177,841499,419380,274240,1282
582,KARNATAKA,Chikkaballapura,1255104,636437,618667,783222,442158,341064,77331,212226,206939,20276,200337,1100131,147810,4684,264,85,975,77,100059,219778,193549,187040,80928,55056,6631,843041,380402,1223443,666451,350299,236864,1490
583,KARNATAKA,Bangalore Rural,990923,509172,481751,688749,385311,303438,25756,127770,84108,19457,228556,890429,92252,5368,389,272,1045,85,100770,168165,126285,166677,82235,51015,10741,705888,205062,910950,535765,278153,176083,922
584,KARNATAKA,Ramanagara,1082636,548008,534628,674758,378461,296297,11327,208130,102460,17723,203146,959260,114311,6390,383,104,859,57,98447,187673,119218,155358,77233,46318,8802,693049,324721,1017770,559082,297330,224785,1439
585,GOA,North Goa,818008,416677,401331,663060,351738,311322,28782,15402,14120,8862,289274,622213,57941,134169,618,553,546,166,40968,101521,148792,153887,87513,86781,16601,636063,99538,735601,380926,260533,175035,1514
586,GOA,South Goa,640537,322463,318074,502427,264085,238342,47545,15952,12640,5846,215152,341664,63623,231961,855,542,563,92,29874,73039,119869,108989,64786,57460,9579,463596,88577,552173,314480,194872,130605,580
587,LAKSHADWEEP,Lakshadweep,64473,33123,31350,52553,28023,24530,30605,0,0,264,18489,1788,62268,317,8,10,11,7,5641,13391,13836,13997,6642,3491,1059,58057,5953,64010,33877,19244,11237,115
588,KERALA,Kasaragod,1307375,628613,678762,1037492,516476,521016,24907,23732,38774,24496,375996,729987,486913,87454,151,362,130,152,115476,268084,230416,238900,122657,76192,16585,1068310,212905,1281215,688763,369883,246975,1754
589,KERALA,Kannur,2523003,1181446,1341557,2138434,1012956,1125478,21230,36549,82988,12875,691704,1509592,742483,262526,424,1118,193,722,204713,487016,491844,540383,308670,217203,40277,2290106,279352,2569458,1187177,741984,588081,5761
590,KERALA,Wayanad,817420,401684,415736,645585,328136,317449,76967,52759,101630,4574,181114,404460,234185,174453,61,312,1797,286,65326,144896,137227,184266,87042,51111,8786,678654,131211,809865,412806,246590,157326,698
591,KERALA,Kozhikode,3086293,1470942,1615351,2615443,1266939,1348504,7799,26543,64198,13312,844928,1734958,1211131,131516,297,235,601,588,247996,564392,647221,630818,351267,250117,53166,2744977,335520,3080497,1487644,909581,686109,2959
592,KERALA,Malappuram,4112920,1960328,2152592,3311315,1597404,1713911,11718,57567,117405,18423,869029,1135259,2888849,81556,205,179,68,579,415601,770417,814285,933793,392867,203779,41344,3572086,622345,4194431,2406005,1041361,662311,3243
593,KERALA,Palakkad,2809934,1359478,1450456,2239492,1122600,1116892,24658,67805,249949,25035,699551,1875980,812936,114397,220,238,78,400,249198,492864,608176,572412,232109,180540,36370,2371669,439934,2811603,1395222,802611,608966,3135
594,KERALA,Thrissur,3121200,1480763,1640437,2678548,1282261,1396287,5068,41786,73941,27883,952117,1823442,532839,757484,259,278,62,585,222627,445696,524387,821831,362657,338600,71535,2787333,307665,3094998,1394214,931841,792182,2963
595,KERALA,Ernakulam,3282388,1619557,1662831,2855676,1425723,1429953,8210,50423,71391,23976,1103553,1509557,514397,1248137,860,614,1176,1083,212263,446380,554817,702511,389793,429880,113133,2848777,268315,3117092,1396968,1024720,858010,2690
596,KERALA,Idukki,1108974,552808,556166,923010,471881,451129,27820,100917,145698,6888,262860,541854,82206,481507,100,189,44,384,79149,166604,209398,261237,136428,86136,19252,958204,126589,1084793,494456,352163,261471,884
597,KERALA,Kottayam,1974551,968289,1006262,1749798,861592,888206,10998,49991,63052,18523,604169,983598,126499,858608,204,358,83,565,117681,271496,373998,475724,280720,221350,52339,1793308,134393,1927701,811653,596302,565048,1548
598,KERALA,Alappuzha,2127789,1013142,1114647,1852797,890552,962245,3399,25237,71706,35865,671663,1460447,224545,435056,268,146,74,311,133039,334339,418953,573306,274789,198858,58096,1991380,163991,2155371,891512,648522,585591,2164
599,KERALA,Pathanamthitta,1197412,561716,635696,1062553,499181,563372,4161,41414,55455,11074,284851,681666,55074,456404,153,150,44,262,64054,146138,202197,371128,172884,123549,32477,1112427,71053,1183480,479207,346161,370887,1157
600,KERALA,Kollam,2635375,1246968,1388407,2240273,1074345,1165928,5566,56693,92193,21511,741628,1697635,508500,421598,208,272,63,619,172247,406592,562529,595191,307950,233402,64052,2341963,231286,2573249,1177359,795245,660965,1806
601,KERALA,Thiruvananthapuram,3301427,1581678,1719749,2785408,1354857,1430551,14135,38837,94470,28587,1069775,2194057,452915,630573,404,301,76,1082,206328,460690,642470,682156,389161,381782,76129,2838716,309042,3147758,1488441,989238,820024,3724
602,TAMIL NADU,Thiruvallur,3728104,1876062,1852042,2791721,1495711,1296010,23551,73444,270586,58240,1135784,3325823,143093,233633,1422,951,3693,530,181452,461918,600731,622789,303091,451321,66378,2687680,610048,3297728,1925296,1154775,643614,4419
603,TAMIL NADU,Chennai,4646732,2335844,2310888,3776276,1968079,1808197,4854,14454,13674,37345,1751824,3751322,439270,358662,2851,2804,51708,1759,167207,516445,720331,801050,464207,905515,67277,3642032,419065,4061097,2271657,1468902,899279,6894
604,TAMIL NADU,Kancheepuram,3998252,2012958,1985294,3013382,1611461,1401921,20605,89343,272514,54732,1257225,3537399,173785,256762,1620,990,4962,756,183054,535947,608188,634172,312208,526886,67354,2867809,678374,3546183,2076492,1200284,715895,5581
605,TAMIL NADU,Vellore,3936331,1961688,1974643,2773928,1504355,1269573,36292,175108,391955,136415,985852,3397857,414760,111390,676,438,3514,251,191963,721473,719731,641585,311434,308514,71127,2965827,891430,3857257,2096113,1116437,720713,3068
606,TAMIL NADU,Tiruvannamalai,2464875,1235889,1228986,1626813,909803,717010,44998,292641,525063,46720,373753,2294369,91636,66987,232,157,7898,110,203879,442688,423135,343955,174560,158041,36454,1782712,672427,2455139,1301347,683904,477668,1956
607,TAMIL NADU,Viluppuram,3458873,1740819,1718054,2195776,1234479,961297,37289,369646,832213,38237,463153,3174941,133896,138279,325,238,4032,278,202930,646306,549742,508930,246856,229726,45680,2430170,999902,3430072,1881463,949892,624042,3476
608,TAMIL NADU,Salem,3482056,1781571,1700485,2285562,1285107,1000455,58880,257004,454210,141503,841443,3326357,95487,53841,412,174,992,246,188672,571061,518763,457866,242306,296399,60365,2335432,955045,3290477,1737345,1029479,713294,1938
609,TAMIL NADU,Namakkal,1726601,869280,857321,1176131,653312,522819,27676,158473,253726,38797,447249,1673652,32483,16909,183,108,84,199,123573,297179,247516,214836,126468,169206,21582,1200360,388418,1588778,817905,510413,397064,1219
610,TAMIL NADU,Erode,2251744,1129868,1121876,1492662,828300,664362,10856,178170,370212,54322,593069,2115455,76098,55899,435,148,639,157,175017,345914,319484,269016,155344,215514,30391,1510680,608003,2118683,1006543,701326,542295,1580
611,TAMIL NADU,The Nilgiris,735394,360143,375251,569647,299447,270200,16722,15645,79100,3895,251334,569477,78452,84610,338,382,910,87,47555,122821,130678,133569,76132,69657,8328,588740,114497,703237,352516,231451,150804,623
612,TAMIL NADU,Dindigul,2159775,1080938,1078837,1481834,816180,665654,3969,165405,467959,30829,440962,1879494,105012,169945,313,256,71,138,207751,386421,372636,282628,153100,163050,29443,1595029,480681,2075710,1065734,647806,443528,2707
613,TAMIL NADU,Karur,1064493,528184,536309,727044,401726,325318,278,85872,200837,11340,245249,993666,53292,16483,115,29,7,79,76629,190229,167466,146666,77874,85595,14951,759410,276930,1036340,501585,320645,241843,420
614,TAMIL NADU,Tiruchirappalli,2722290,1352284,1370006,2038981,1087765,951216,8784,170669,378782,30386,634142,2279413,190964,246156,324,250,628,253,229415,444023,447474,418930,223178,291506,70392,2124918,401149,2526067,1346661,797258,575960,2411
615,TAMIL NADU,Perambalur,565223,282157,283066,375823,208011,167812,1292,117304,118278,5343,58801,521658,32702,10301,83,39,38,26,85210,106751,85101,71650,41447,44025,9189,443373,109011,552384,291371,158218,115151,483
616,TAMIL NADU,Ariyalur,754894,374703,380191,480604,269582,211022,5448,107312,166837,13564,72138,708397,7942,37403,104,88,65,42,60697,134123,113437,96860,53934,57524,16126,532701,233438,766139,380484,216103,157771,536
617,TAMIL NADU,Cuddalore,2605914,1311697,1294217,1815281,1000322,814959,7759,165170,539412,32027,433271,2391675,123749,83334,401,236,1280,138,169844,412237,418769,386652,186394,227530,67411,1868837,634041,2502878,1364411,764669,473617,3217
618,TAMIL NADU,Nagapattinam,1616450,798127,818323,1213008,640916,572092,1909,67482,345057,11555,247900,1435072,128617,47579,184,450,963,110,136593,323359,313357,249630,122350,125639,35762,1306690,253572,1560262,828444,463326,323706,974
619,TAMIL NADU,Thiruvarur,1264277,626693,637584,946471,503085,443386,1568,69883,295188,10440,164657,1132785,96092,33192,258,151,279,64,138960,250163,243773,203450,103908,99082,28166,1067502,175564,1243066,627880,377118,257116,2163
620,TAMIL NADU,Thanjavur,2405890,1182416,1223474,1790998,944264,846734,1822,129913,415361,31200,397605,2075870,190814,133971,231,795,1256,148,138375,431983,419605,373111,178126,222410,49261,1812871,461123,2273994,1193095,712017,499235,1543
621,TAMIL NADU,Pudukkottai,1618345,803188,815157,1110545,608776,501769,636,209270,305149,13941,233333,1428784,114194,72850,119,81,32,293,97231,283299,270046,251855,121706,111731,31315,1167183,447346,1614529,835853,470428,311175,889
622,TAMIL NADU,Sivaganga,1339101,668672,670429,959744,526304,433440,396,141003,199563,14656,264949,1186078,74310,75481,150,80,109,24,101778,216931,236700,199263,103903,115894,23941,998410,311112,1309522,666218,391356,280462,1065
623,TAMIL NADU,Madurai,3038252,1526475,1511777,2273430,1223810,1049620,5474,92719,372828,47293,841792,2760502,168881,97711,520,199,1532,305,234611,525151,532616,453509,250285,363152,39350,2398674,449125,2847799,1528178,913715,593827,2532
624,TAMIL NADU,Theni,1245899,625683,620216,870080,479403,390677,881,38367,315161,14939,223175,1148990,56751,37574,152,79,28,74,90590,219747,213496,156676,95231,101147,14674,891561,270738,1162299,618923,373564,252267,1145
625,TAMIL NADU,Virudhunagar,1942288,967709,974579,1398788,760375,638413,1112,57153,208702,35298,649005,1822626,47838,67405,245,87,98,75,163264,398670,317054,230321,138306,167506,35156,1450277,403246,1853523,987538,575006,378174,1570
626,TAMIL NADU,Ramanathapuram,1353445,682658,670787,978946,536487,442459,546,173767,153874,25228,250108,1047411,208038,91139,154,86,29,36,246909,293886,236511,189132,105978,97405,16785,1186606,107292,1293898,708322,389764,252888,2471
627,TAMIL NADU,Thoothukkudi,1750176,865021,885155,1349697,703106,646591,2445,48515,200644,22863,476073,1373920,80740,291908,127,286,53,112,153922,372036,315817,227154,133010,155613,31525,1389077,265032,1654109,887717,499377,361374,1708
628,TAMIL NADU,Tirunelveli,3077233,1520912,1556321,2273457,1210710,1062747,5161,115715,379763,239664,701312,2425630,303368,342254,268,373,144,450,263517,618656,517646,390495,220088,247635,71437,2329474,621010,2950484,1554277,876129,644563,2264
629,TAMIL NADU,Kanniyakumari,1870374,926345,944029,1548738,780541,768197,3728,15610,72867,35789,555354,909872,78590,876299,160,438,156,10,134236,331559,314029,322511,226312,254107,43034,1625788,210901,1836689,887052,556548,425849,925
630,TAMIL NADU,Dharmapuri,1506843,774303,732540,917709,527599,390110,30914,201328,267345,15341,267156,1452956,38304,14089,164,39,37,87,129778,240222,221194,177877,103367,112592,26069,1011099,512824,1523923,804186,434328,267536,793
631,TAMIL NADU,Krishnagiri,1879809,960232,919577,1187958,667062,520896,10969,236038,263328,21918,356495,1723737,115303,35956,468,121,373,221,135813,290351,289026,276694,133744,137081,24128,1286837,578724,1865561,1034474,533183,311238,914
632,TAMIL NADU,Coimbatore,3458045,1729297,1728748,2635907,1394790,1241117,14097,80217,230026,50085,1207622,3044145,211035,190314,1112,435,3284,237,220388,466745,523563,526165,273098,440520,53709,2504188,519919,3024107,1579517,1117221,757738,3569
633,TAMIL NADU,Tiruppur,2479052,1246159,1232893,1760566,959623,800943,2718,135817,246333,40988,842999,2278835,123983,70015,455,198,371,119,192583,444390,369432,298635,170870,179733,21436,1677079,552447,2229526,1177987,794639,504674,1752
634,PONDICHERRY,Yanam,55626,27301,28325,39274,19919,19355,0,291,3324,146,12999,53537,1191,873,3,1,4,4,3804,10954,8806,8044,4101,3836,1315,40860,14923,55783,31973,15235,8402,16
635,PONDICHERRY,PONDICHERRY,950289,468258,482031,726649,380946,345703,0,9393,51908,6350,280454,855294,32674,58328,245,366,1328,147,61364,127754,150478,152482,81519,134067,17367,725031,146861,871892,473705,299746,176204,634
636,PONDICHERRY,Mahe,41816,19143,22673,36470,16610,19860,0,43,82,69,11608,27940,12856,958,3,21,14,3,2948,6043,7930,8773,5711,4475,978,36858,2993,39851,19760,12543,9428,85
637,PONDICHERRY,Karaikal,200222,97809,102413,154916,79903,75013,0,2372,13077,1327,51525,152638,28835,18391,46,63,54,14,18943,32899,33458,29456,15930,18998,4877,154561,32717,187278,102333,60089,37434,366
638,ANDAMAN AND NICOBAR ISLANDS,Nicobars,36842,20727,16115,25332,15397,9935,11483,322,242,2560,14001,8681,1336,26077,343,119,0,248,2406,5984,7699,6325,3668,1300,364,27746,9781,37527,18786,12088,5922,46
639,ANDAMAN AND NICOBAR ISLANDS,North  AND Middle Andaman,105597,54861,50736,78683,43186,35497,343,10727,1915,260,25677,81163,2165,21870,77,84,4,47,16126,21215,21293,12707,10042,5133,809,87325,22422,109747,57350,30741,17464,42
640,ANDAMAN AND NICOBAR ISLANDS,South Andaman,238142,127283,110859,190266,105794,84472,1973,5518,2624,907,87782,174452,28912,33037,866,135,27,269,16301,33267,42741,42150,29910,22388,3077,189834,36289,226123,128402,76332,33128,280
